Brow.	Name
ğŸ˜€	GRINNING FACE
ğŸ˜	GRINNING FACE WITH SMILING EYES
ğŸ˜‚	FACE WITH TEARS OF JOY
ğŸ¤£	ROLLING ON THE FLOOR LAUGHING
ğŸ˜ƒ	SMILING FACE WITH OPEN MOUTH
ğŸ˜„	SMILING FACE WITH OPEN MOUTH AND SMILING EYESâ‰Š smiling face with open mouth & smiling eyes
ğŸ˜…	SMILING FACE WITH OPEN MOUTH AND COLD SWEATâ‰Š smiling face with open mouth & cold sweat
ğŸ˜†	SMILING FACE WITH OPEN MOUTH AND TIGHTLY-CLOSED EYESâ‰Š smiling face with open mouth & closed eyes
ğŸ˜‰	WINKING FACE
ğŸ˜Š	SMILING FACE WITH SMILING EYES
ğŸ˜‹	FACE SAVOURING DELICIOUS FOOD
ğŸ˜	SMILING FACE WITH SUNGLASSES
ğŸ˜	SMILING FACE WITH HEART-SHAPED EYESâ‰Š smiling face with heart-eyes
ğŸ˜˜	FACE THROWING A KISS
ğŸ˜—	KISSING FACE
ğŸ˜™	KISSING FACE WITH SMILING EYES
ğŸ˜š	KISSING FACE WITH CLOSED EYES
â˜º	WHITE SMILING FACEâ‰Š smiling face
ğŸ™‚	SLIGHTLY SMILING FACE
ğŸ¤—	HUGGING FACE
ğŸ¤”	THINKING FACE
ğŸ˜	NEUTRAL FACE
ğŸ˜‘	EXPRESSIONLESS FACE
ğŸ˜¶	FACE WITHOUT MOUTH
ğŸ™„	FACE WITH ROLLING EYES
ğŸ˜	SMIRKING FACE
ğŸ˜£	PERSEVERING FACE
ğŸ˜¥	DISAPPOINTED BUT RELIEVED FACE
ğŸ˜®	FACE WITH OPEN MOUTH
ğŸ¤	ZIPPER-MOUTH FACE
ğŸ˜¯	HUSHED FACE
ğŸ˜ª	SLEEPY FACE
ğŸ˜«	TIRED FACE
ğŸ˜´	SLEEPING FACE
ğŸ˜Œ	RELIEVED FACE
ğŸ¤“	NERD FACE
ğŸ˜›	FACE WITH STUCK-OUT TONGUE
ğŸ˜œ	FACE WITH STUCK-OUT TONGUE AND WINKING EYEâ‰Š face with stuck-out tongue & winking eye
ğŸ˜	FACE WITH STUCK-OUT TONGUE AND TIGHTLY-CLOSED EYESâ‰Š face with stuck-out tongue & closed eyes
ğŸ¤¤	DROOLING FACE
ğŸ˜’	UNAMUSED FACE
ğŸ˜“	FACE WITH COLD SWEAT
ğŸ˜”	PENSIVE FACE
ğŸ˜•	CONFUSED FACE
ğŸ™ƒ	UPSIDE-DOWN FACE
ğŸ¤‘	MONEY-MOUTH FACE
ğŸ˜²	ASTONISHED FACE
â˜¹	WHITE FROWNING FACEâ‰Š frowning face
ğŸ™	SLIGHTLY FROWNING FACE
ğŸ˜–	CONFOUNDED FACE
ğŸ˜	DISAPPOINTED FACE
ğŸ˜Ÿ	WORRIED FACE
ğŸ˜¤	FACE WITH LOOK OF TRIUMPHâ‰Š face with steam from nose
ğŸ˜¢	CRYING FACE
ğŸ˜­	LOUDLY CRYING FACE
ğŸ˜¦	FROWNING FACE WITH OPEN MOUTH
ğŸ˜§	ANGUISHED FACE
ğŸ˜¨	FEARFUL FACE
ğŸ˜©	WEARY FACE
ğŸ˜¬	GRIMACING FACE
ğŸ˜°	FACE WITH OPEN MOUTH AND COLD SWEATâ‰Š face with open mouth & cold sweat
ğŸ˜±	FACE SCREAMING IN FEAR
ğŸ˜³	FLUSHED FACE
ğŸ˜µ	DIZZY FACE
ğŸ˜¡	POUTING FACE
ğŸ˜ 	ANGRY FACE
ğŸ˜‡	SMILING FACE WITH HALO
ğŸ¤ 	FACE WITH COWBOY HATâ‰Š cowboy hat face
ğŸ¤¡	CLOWN FACE
ğŸ¤¥	LYING FACE
ğŸ˜·	FACE WITH MEDICAL MASK
ğŸ¤’	FACE WITH THERMOMETER
ğŸ¤•	FACE WITH HEAD-BANDAGE
ğŸ¤¢	NAUSEATED FACE
ğŸ¤§	SNEEZING FACE
ğŸ˜ˆ	SMILING FACE WITH HORNS
ğŸ‘¿	IMP
ğŸ‘¹	JAPANESE OGREâ‰Š ogre
ğŸ‘º	JAPANESE GOBLINâ‰Š goblin
ğŸ’€	SKULL
â˜ 	SKULL AND CROSSBONES
ğŸ‘»	GHOST
ğŸ‘½	EXTRATERRESTRIAL ALIENâ‰Š alien
ğŸ‘¾	ALIEN MONSTER
ğŸ¤–	ROBOT FACE
ğŸ’©	PILE OF POO
ğŸ˜º	SMILING CAT FACE WITH OPEN MOUTH
ğŸ˜¸	GRINNING CAT FACE WITH SMILING EYES
ğŸ˜¹	CAT FACE WITH TEARS OF JOY
ğŸ˜»	SMILING CAT FACE WITH HEART-SHAPED EYESâ‰Š smiling cat face with heart-eyes
ğŸ˜¼	CAT FACE WITH WRY SMILE
ğŸ˜½	KISSING CAT FACE WITH CLOSED EYES
ğŸ™€	WEARY CAT FACE
ğŸ˜¿	CRYING CAT FACE
ğŸ˜¾	POUTING CAT FACE
ğŸ™ˆ	SEE-NO-EVIL MONKEYâ‰Š see-no-evil
ğŸ™‰	HEAR-NO-EVIL MONKEYâ‰Š hear-no-evil
ğŸ™Š	SPEAK-NO-EVIL MONKEYâ‰Š speak-no-evil
ğŸ‘¦	BOY
ğŸ‘¦ğŸ»	boy, type-1-2
ğŸ‘¦ğŸ¼	boy, type-3
ğŸ‘¦ğŸ½	boy, type-4
ğŸ‘¦ğŸ¾	boy, type-5
ğŸ‘¦ğŸ¿	boy, type-6
ğŸ‘§	GIRL
ğŸ‘§ğŸ»	girl, type-1-2
ğŸ‘§ğŸ¼	girl, type-3
ğŸ‘§ğŸ½	girl, type-4
ğŸ‘§ğŸ¾	girl, type-5
ğŸ‘§ğŸ¿	girl, type-6
ğŸ‘¨	MAN
ğŸ‘¨ğŸ»	man, type-1-2
ğŸ‘¨ğŸ¼	man, type-3
ğŸ‘¨ğŸ½	man, type-4
ğŸ‘¨ğŸ¾	man, type-5
ğŸ‘¨ğŸ¿	man, type-6
ğŸ‘©	WOMAN
ğŸ‘©ğŸ»	woman, type-1-2
ğŸ‘©ğŸ¼	woman, type-3
ğŸ‘©ğŸ½	woman, type-4
ğŸ‘©ğŸ¾	woman, type-5
ğŸ‘©ğŸ¿	woman, type-6
ğŸ‘´	OLDER MANâ‰Š old man
ğŸ‘´ğŸ»	old man, type-1-2
ğŸ‘´ğŸ¼	old man, type-3
ğŸ‘´ğŸ½	old man, type-4
ğŸ‘´ğŸ¾	old man, type-5
ğŸ‘´ğŸ¿	old man, type-6
ğŸ‘µ	OLDER WOMANâ‰Š old woman
ğŸ‘µğŸ»	old woman, type-1-2
ğŸ‘µğŸ¼	old woman, type-3
ğŸ‘µğŸ½	old woman, type-4
ğŸ‘µğŸ¾	old woman, type-5
ğŸ‘µğŸ¿	old woman, type-6
ğŸ‘¶	BABY
ğŸ‘¶ğŸ»	baby, type-1-2
ğŸ‘¶ğŸ¼	baby, type-3
ğŸ‘¶ğŸ½	baby, type-4
ğŸ‘¶ğŸ¾	baby, type-5
ğŸ‘¶ğŸ¿	baby, type-6
ğŸ‘¼	BABY ANGEL
ğŸ‘¼ğŸ»	baby angel, type-1-2
ğŸ‘¼ğŸ¼	baby angel, type-3
ğŸ‘¼ğŸ½	baby angel, type-4
ğŸ‘¼ğŸ¾	baby angel, type-5
ğŸ‘¼ğŸ¿	baby angel, type-6
ğŸ‘®	POLICE OFFICER
ğŸ‘®ğŸ»	police officer, type-1-2
ğŸ‘®ğŸ¼	police officer, type-3
ğŸ‘®ğŸ½	police officer, type-4
ğŸ‘®ğŸ¾	police officer, type-5
ğŸ‘®ğŸ¿	police officer, type-6
ğŸ•µ	SLEUTH OR SPYâ‰Š detective
ğŸ•µğŸ»	detective, type-1-2
ğŸ•µğŸ¼	detective, type-3
ğŸ•µğŸ½	detective, type-4
ğŸ•µğŸ¾	detective, type-5
ğŸ•µğŸ¿	detective, type-6
ğŸ’‚	GUARDSMAN
ğŸ’‚ğŸ»	guardsman, type-1-2
ğŸ’‚ğŸ¼	guardsman, type-3
ğŸ’‚ğŸ½	guardsman, type-4
ğŸ’‚ğŸ¾	guardsman, type-5
ğŸ’‚ğŸ¿	guardsman, type-6
ğŸ‘·	CONSTRUCTION WORKER
ğŸ‘·ğŸ»	construction worker, type-1-2
ğŸ‘·ğŸ¼	construction worker, type-3
ğŸ‘·ğŸ½	construction worker, type-4
ğŸ‘·ğŸ¾	construction worker, type-5
ğŸ‘·ğŸ¿	construction worker, type-6
ğŸ‘³	MAN WITH TURBANâ‰Š person with turban
ğŸ‘³ğŸ»	person with turban, type-1-2
ğŸ‘³ğŸ¼	person with turban, type-3
ğŸ‘³ğŸ½	person with turban, type-4
ğŸ‘³ğŸ¾	person with turban, type-5
ğŸ‘³ğŸ¿	person with turban, type-6
ğŸ‘±	PERSON WITH BLOND HAIRâ‰Š blond person
ğŸ‘±ğŸ»	blond person, type-1-2
ğŸ‘±ğŸ¼	blond person, type-3
ğŸ‘±ğŸ½	blond person, type-4
ğŸ‘±ğŸ¾	blond person, type-5
ğŸ‘±ğŸ¿	blond person, type-6
ğŸ…	FATHER CHRISTMASâ‰Š santa claus
ğŸ…ğŸ»	santa claus, type-1-2
ğŸ…ğŸ¼	santa claus, type-3
ğŸ…ğŸ½	santa claus, type-4
ğŸ…ğŸ¾	santa claus, type-5
ğŸ…ğŸ¿	santa claus, type-6
ğŸ¤¶	MOTHER CHRISTMAS
ğŸ¤¶ğŸ»	mother christmas, type-1-2
ğŸ¤¶ğŸ¼	mother christmas, type-3
ğŸ¤¶ğŸ½	mother christmas, type-4
ğŸ¤¶ğŸ¾	mother christmas, type-5
ğŸ¤¶ğŸ¿	mother christmas, type-6
ğŸ‘¸	PRINCESS
ğŸ‘¸ğŸ»	princess, type-1-2
ğŸ‘¸ğŸ¼	princess, type-3
ğŸ‘¸ğŸ½	princess, type-4
ğŸ‘¸ğŸ¾	princess, type-5
ğŸ‘¸ğŸ¿	princess, type-6
ğŸ¤´	PRINCE
ğŸ¤´ğŸ»	prince, type-1-2
ğŸ¤´ğŸ¼	prince, type-3
ğŸ¤´ğŸ½	prince, type-4
ğŸ¤´ğŸ¾	prince, type-5
ğŸ¤´ğŸ¿	prince, type-6
ğŸ‘°	BRIDE WITH VEIL
ğŸ‘°ğŸ»	bride with veil, type-1-2
ğŸ‘°ğŸ¼	bride with veil, type-3
ğŸ‘°ğŸ½	bride with veil, type-4
ğŸ‘°ğŸ¾	bride with veil, type-5
ğŸ‘°ğŸ¿	bride with veil, type-6
ğŸ¤µ	MAN IN TUXEDO
ğŸ¤µğŸ»	man in tuxedo, type-1-2
ğŸ¤µğŸ¼	man in tuxedo, type-3
ğŸ¤µğŸ½	man in tuxedo, type-4
ğŸ¤µğŸ¾	man in tuxedo, type-5
ğŸ¤µğŸ¿	man in tuxedo, type-6
ğŸ¤°	PREGNANT WOMAN
ğŸ¤°ğŸ»	pregnant woman, type-1-2
ğŸ¤°ğŸ¼	pregnant woman, type-3
ğŸ¤°ğŸ½	pregnant woman, type-4
ğŸ¤°ğŸ¾	pregnant woman, type-5
ğŸ¤°ğŸ¿	pregnant woman, type-6
ğŸ‘²	MAN WITH GUA PI MAOâ‰Š man with chinese cap
ğŸ‘²ğŸ»	man with chinese cap, type-1-2
ğŸ‘²ğŸ¼	man with chinese cap, type-3
ğŸ‘²ğŸ½	man with chinese cap, type-4
ğŸ‘²ğŸ¾	man with chinese cap, type-5
ğŸ‘²ğŸ¿	man with chinese cap, type-6
ğŸ™	PERSON FROWNING
ğŸ™ğŸ»	person frowning, type-1-2
ğŸ™ğŸ¼	person frowning, type-3
ğŸ™ğŸ½	person frowning, type-4
ğŸ™ğŸ¾	person frowning, type-5
ğŸ™ğŸ¿	person frowning, type-6
ğŸ™	PERSON WITH POUTING FACEâ‰Š person pouting
ğŸ™ğŸ»	person pouting, type-1-2
ğŸ™ğŸ¼	person pouting, type-3
ğŸ™ğŸ½	person pouting, type-4
ğŸ™ğŸ¾	person pouting, type-5
ğŸ™ğŸ¿	person pouting, type-6
ğŸ™…	FACE WITH NO GOOD GESTUREâ‰Š person gesturing not ok
ğŸ™…ğŸ»	person gesturing not ok, type-1-2
ğŸ™…ğŸ¼	person gesturing not ok, type-3
ğŸ™…ğŸ½	person gesturing not ok, type-4
ğŸ™…ğŸ¾	person gesturing not ok, type-5
ğŸ™…ğŸ¿	person gesturing not ok, type-6
ğŸ™†	FACE WITH OK GESTUREâ‰Š person gesturing ok
ğŸ™†ğŸ»	person gesturing ok, type-1-2
ğŸ™†ğŸ¼	person gesturing ok, type-3
ğŸ™†ğŸ½	person gesturing ok, type-4
ğŸ™†ğŸ¾	person gesturing ok, type-5
ğŸ™†ğŸ¿	person gesturing ok, type-6
ğŸ’	INFORMATION DESK PERSONâ‰Š person tipping hand
ğŸ’ğŸ»	person tipping hand, type-1-2
ğŸ’ğŸ¼	person tipping hand, type-3
ğŸ’ğŸ½	person tipping hand, type-4
ğŸ’ğŸ¾	person tipping hand, type-5
ğŸ’ğŸ¿	person tipping hand, type-6
ğŸ™‹	HAPPY PERSON RAISING ONE HANDâ‰Š person raising hand
ğŸ™‹ğŸ»	person raising hand, type-1-2
ğŸ™‹ğŸ¼	person raising hand, type-3
ğŸ™‹ğŸ½	person raising hand, type-4
ğŸ™‹ğŸ¾	person raising hand, type-5
ğŸ™‹ğŸ¿	person raising hand, type-6
ğŸ™‡	PERSON BOWING DEEPLYâ‰Š person bowing
ğŸ™‡ğŸ»	person bowing, type-1-2
ğŸ™‡ğŸ¼	person bowing, type-3
ğŸ™‡ğŸ½	person bowing, type-4
ğŸ™‡ğŸ¾	person bowing, type-5
ğŸ™‡ğŸ¿	person bowing, type-6
ğŸ¤¦	FACE PALMâ‰Š person facepalming
ğŸ¤¦ğŸ»	person facepalming, type-1-2
ğŸ¤¦ğŸ¼	person facepalming, type-3
ğŸ¤¦ğŸ½	person facepalming, type-4
ğŸ¤¦ğŸ¾	person facepalming, type-5
ğŸ¤¦ğŸ¿	person facepalming, type-6
ğŸ¤·	SHRUGâ‰Š person shrugging
ğŸ¤·ğŸ»	person shrugging, type-1-2
ğŸ¤·ğŸ¼	person shrugging, type-3
ğŸ¤·ğŸ½	person shrugging, type-4
ğŸ¤·ğŸ¾	person shrugging, type-5
ğŸ¤·ğŸ¿	person shrugging, type-6
ğŸ’†	FACE MASSAGEâ‰Š person getting massage
ğŸ’†ğŸ»	person getting massage, type-1-2
ğŸ’†ğŸ¼	person getting massage, type-3
ğŸ’†ğŸ½	person getting massage, type-4
ğŸ’†ğŸ¾	person getting massage, type-5
ğŸ’†ğŸ¿	person getting massage, type-6
ğŸ’‡	HAIRCUTâ‰Š person getting haircut
ğŸ’‡ğŸ»	person getting haircut, type-1-2
ğŸ’‡ğŸ¼	person getting haircut, type-3
ğŸ’‡ğŸ½	person getting haircut, type-4
ğŸ’‡ğŸ¾	person getting haircut, type-5
ğŸ’‡ğŸ¿	person getting haircut, type-6
ğŸš¶	PEDESTRIANâ‰Š person walking
ğŸš¶ğŸ»	person walking, type-1-2
ğŸš¶ğŸ¼	person walking, type-3
ğŸš¶ğŸ½	person walking, type-4
ğŸš¶ğŸ¾	person walking, type-5
ğŸš¶ğŸ¿	person walking, type-6
ğŸƒ	RUNNERâ‰Š person running
ğŸƒğŸ»	person running, type-1-2
ğŸƒğŸ¼	person running, type-3
ğŸƒğŸ½	person running, type-4
ğŸƒğŸ¾	person running, type-5
ğŸƒğŸ¿	person running, type-6
ğŸ’ƒ	DANCERâ‰Š woman dancing
ğŸ’ƒğŸ»	woman dancing, type-1-2
ğŸ’ƒğŸ¼	woman dancing, type-3
ğŸ’ƒğŸ½	woman dancing, type-4
ğŸ’ƒğŸ¾	woman dancing, type-5
ğŸ’ƒğŸ¿	woman dancing, type-6
ğŸ•º	MAN DANCING
ğŸ•ºğŸ»	man dancing, type-1-2
ğŸ•ºğŸ¼	man dancing, type-3
ğŸ•ºğŸ½	man dancing, type-4
ğŸ•ºğŸ¾	man dancing, type-5
ğŸ•ºğŸ¿	man dancing, type-6
ğŸ‘¯	WOMAN WITH BUNNY EARSâ‰Š people partying
ğŸ•´	MAN IN BUSINESS SUIT LEVITATING
ğŸ—£	SPEAKING HEAD IN SILHOUETTEâ‰Š speaking head
ğŸ‘¤	BUST IN SILHOUETTE
ğŸ‘¥	BUSTS IN SILHOUETTE
ğŸ‘«	MAN AND WOMAN HOLDING HANDS
ğŸ‘¬	TWO MEN HOLDING HANDS
ğŸ‘­	TWO WOMEN HOLDING HANDS
ğŸ’	KISS
ğŸ‘©â€â¤ï¸â€ğŸ’‹â€ğŸ‘¨	kiss, woman, man
ğŸ‘¨â€â¤ï¸â€ğŸ’‹â€ğŸ‘¨	kiss, man, man
ğŸ‘©â€â¤ï¸â€ğŸ’‹â€ğŸ‘©	kiss, woman, woman
ğŸ’‘	COUPLE WITH HEART
ğŸ‘©â€â¤ï¸â€ğŸ‘¨	couple with heart, woman, man
ğŸ‘¨â€â¤ï¸â€ğŸ‘¨	couple with heart, man, man
ğŸ‘©â€â¤ï¸â€ğŸ‘©	couple with heart, woman, woman
ğŸ‘ª	FAMILY
ğŸ‘¨â€ğŸ‘©â€ğŸ‘¦	family, man, woman, boy
ğŸ‘¨â€ğŸ‘©â€ğŸ‘§	family, man, woman, girl
ğŸ‘¨â€ğŸ‘©â€ğŸ‘§â€ğŸ‘¦	family, man, woman, girl, boy
ğŸ‘¨â€ğŸ‘©â€ğŸ‘¦â€ğŸ‘¦	family, man, woman, boy, boy
ğŸ‘¨â€ğŸ‘©â€ğŸ‘§â€ğŸ‘§	family, man, woman, girl, girl
ğŸ‘¨â€ğŸ‘¨â€ğŸ‘¦	family, man, man, boy
ğŸ‘¨â€ğŸ‘¨â€ğŸ‘§	family, man, man, girl
ğŸ‘¨â€ğŸ‘¨â€ğŸ‘§â€ğŸ‘¦	family, man, man, girl, boy
ğŸ‘¨â€ğŸ‘¨â€ğŸ‘¦â€ğŸ‘¦	family, man, man, boy, boy
ğŸ‘¨â€ğŸ‘¨â€ğŸ‘§â€ğŸ‘§	family, man, man, girl, girl
ğŸ‘©â€ğŸ‘©â€ğŸ‘¦	family, woman, woman, boy
ğŸ‘©â€ğŸ‘©â€ğŸ‘§	family, woman, woman, girl
ğŸ‘©â€ğŸ‘©â€ğŸ‘§â€ğŸ‘¦	family, woman, woman, girl, boy
ğŸ‘©â€ğŸ‘©â€ğŸ‘¦â€ğŸ‘¦	family, woman, woman, boy, boy
ğŸ‘©â€ğŸ‘©â€ğŸ‘§â€ğŸ‘§	family, woman, woman, girl, girl
ğŸ»	EMOJI MODIFIER FITZPATRICK TYPE-1-2â‰Š type-1-2
ğŸ¼	EMOJI MODIFIER FITZPATRICK TYPE-3â‰Š type-3
ğŸ½	EMOJI MODIFIER FITZPATRICK TYPE-4â‰Š type-4
ğŸ¾	EMOJI MODIFIER FITZPATRICK TYPE-5â‰Š type-5
ğŸ¿	EMOJI MODIFIER FITZPATRICK TYPE-6â‰Š type-6
ğŸ’ª	FLEXED BICEPS
ğŸ’ªğŸ»	flexed biceps, type-1-2
ğŸ’ªğŸ¼	flexed biceps, type-3
ğŸ’ªğŸ½	flexed biceps, type-4
ğŸ’ªğŸ¾	flexed biceps, type-5
ğŸ’ªğŸ¿	flexed biceps, type-6
ğŸ¤³	SELFIE
ğŸ¤³ğŸ»	selfie, type-1-2
ğŸ¤³ğŸ¼	selfie, type-3
ğŸ¤³ğŸ½	selfie, type-4
ğŸ¤³ğŸ¾	selfie, type-5
ğŸ¤³ğŸ¿	selfie, type-6
ğŸ‘ˆ	WHITE LEFT POINTING BACKHAND INDEXâ‰Š backhand index pointing left
ğŸ‘ˆğŸ»	backhand index pointing left, type-1-2
ğŸ‘ˆğŸ¼	backhand index pointing left, type-3
ğŸ‘ˆğŸ½	backhand index pointing left, type-4
ğŸ‘ˆğŸ¾	backhand index pointing left, type-5
ğŸ‘ˆğŸ¿	backhand index pointing left, type-6
ğŸ‘‰	WHITE RIGHT POINTING BACKHAND INDEXâ‰Š backhand index pointing right
ğŸ‘‰ğŸ»	backhand index pointing right, type-1-2
ğŸ‘‰ğŸ¼	backhand index pointing right, type-3
ğŸ‘‰ğŸ½	backhand index pointing right, type-4
ğŸ‘‰ğŸ¾	backhand index pointing right, type-5
ğŸ‘‰ğŸ¿	backhand index pointing right, type-6
â˜	WHITE UP POINTING INDEXâ‰Š index pointing up
â˜ğŸ»	index pointing up, type-1-2
â˜ğŸ¼	index pointing up, type-3
â˜ğŸ½	index pointing up, type-4
â˜ğŸ¾	index pointing up, type-5
â˜ğŸ¿	index pointing up, type-6
ğŸ‘†	WHITE UP POINTING BACKHAND INDEXâ‰Š backhand index pointing up
ğŸ‘†ğŸ»	backhand index pointing up, type-1-2
ğŸ‘†ğŸ¼	backhand index pointing up, type-3
ğŸ‘†ğŸ½	backhand index pointing up, type-4
ğŸ‘†ğŸ¾	backhand index pointing up, type-5
ğŸ‘†ğŸ¿	backhand index pointing up, type-6
ğŸ–•	REVERSED HAND WITH MIDDLE FINGER EXTENDEDâ‰Š middle finger
ğŸ–•ğŸ»	middle finger, type-1-2
ğŸ–•ğŸ¼	middle finger, type-3
ğŸ–•ğŸ½	middle finger, type-4
ğŸ–•ğŸ¾	middle finger, type-5
ğŸ–•ğŸ¿	middle finger, type-6
ğŸ‘‡	WHITE DOWN POINTING BACKHAND INDEXâ‰Š backhand index pointing down
ğŸ‘‡ğŸ»	backhand index pointing down, type-1-2
ğŸ‘‡ğŸ¼	backhand index pointing down, type-3
ğŸ‘‡ğŸ½	backhand index pointing down, type-4
ğŸ‘‡ğŸ¾	backhand index pointing down, type-5
ğŸ‘‡ğŸ¿	backhand index pointing down, type-6
âœŒ	VICTORY HAND
âœŒğŸ»	victory hand, type-1-2
âœŒğŸ¼	victory hand, type-3
âœŒğŸ½	victory hand, type-4
âœŒğŸ¾	victory hand, type-5
âœŒğŸ¿	victory hand, type-6
ğŸ¤	HAND WITH INDEX AND MIDDLE FINGERS CROSSEDâ‰Š crossed fingers
ğŸ¤ğŸ»	crossed fingers, type-1-2
ğŸ¤ğŸ¼	crossed fingers, type-3
ğŸ¤ğŸ½	crossed fingers, type-4
ğŸ¤ğŸ¾	crossed fingers, type-5
ğŸ¤ğŸ¿	crossed fingers, type-6
ğŸ––	RAISED HAND WITH PART BETWEEN MIDDLE AND RING FINGERSâ‰Š vulcan salute
ğŸ––ğŸ»	vulcan salute, type-1-2
ğŸ––ğŸ¼	vulcan salute, type-3
ğŸ––ğŸ½	vulcan salute, type-4
ğŸ––ğŸ¾	vulcan salute, type-5
ğŸ––ğŸ¿	vulcan salute, type-6
ğŸ¤˜	SIGN OF THE HORNS
ğŸ¤˜ğŸ»	sign of the horns, type-1-2
ğŸ¤˜ğŸ¼	sign of the horns, type-3
ğŸ¤˜ğŸ½	sign of the horns, type-4
ğŸ¤˜ğŸ¾	sign of the horns, type-5
ğŸ¤˜ğŸ¿	sign of the horns, type-6
ğŸ¤™	CALL ME HAND
ğŸ¤™ğŸ»	call me hand, type-1-2
ğŸ¤™ğŸ¼	call me hand, type-3
ğŸ¤™ğŸ½	call me hand, type-4
ğŸ¤™ğŸ¾	call me hand, type-5
ğŸ¤™ğŸ¿	call me hand, type-6
ğŸ–	RAISED HAND WITH FINGERS SPLAYED
ğŸ–ğŸ»	raised hand with fingers splayed, type-1-2
ğŸ–ğŸ¼	raised hand with fingers splayed, type-3
ğŸ–ğŸ½	raised hand with fingers splayed, type-4
ğŸ–ğŸ¾	raised hand with fingers splayed, type-5
ğŸ–ğŸ¿	raised hand with fingers splayed, type-6
âœ‹	RAISED HAND
âœ‹ğŸ»	raised hand, type-1-2
âœ‹ğŸ¼	raised hand, type-3
âœ‹ğŸ½	raised hand, type-4
âœ‹ğŸ¾	raised hand, type-5
âœ‹ğŸ¿	raised hand, type-6
ğŸ‘Œ	OK HAND SIGNâ‰Š ok hand
ğŸ‘ŒğŸ»	ok hand, type-1-2
ğŸ‘ŒğŸ¼	ok hand, type-3
ğŸ‘ŒğŸ½	ok hand, type-4
ğŸ‘ŒğŸ¾	ok hand, type-5
ğŸ‘ŒğŸ¿	ok hand, type-6
ğŸ‘	THUMBS UP SIGNâ‰Š thumbs up
ğŸ‘ğŸ»	thumbs up, type-1-2
ğŸ‘ğŸ¼	thumbs up, type-3
ğŸ‘ğŸ½	thumbs up, type-4
ğŸ‘ğŸ¾	thumbs up, type-5
ğŸ‘ğŸ¿	thumbs up, type-6
ğŸ‘	THUMBS DOWN SIGNâ‰Š thumbs down
ğŸ‘ğŸ»	thumbs down, type-1-2
ğŸ‘ğŸ¼	thumbs down, type-3
ğŸ‘ğŸ½	thumbs down, type-4
ğŸ‘ğŸ¾	thumbs down, type-5
ğŸ‘ğŸ¿	thumbs down, type-6
âœŠ	RAISED FIST
âœŠğŸ»	raised fist, type-1-2
âœŠğŸ¼	raised fist, type-3
âœŠğŸ½	raised fist, type-4
âœŠğŸ¾	raised fist, type-5
âœŠğŸ¿	raised fist, type-6
ğŸ‘Š	FISTED HAND SIGNâ‰Š oncoming fist
ğŸ‘ŠğŸ»	oncoming fist, type-1-2
ğŸ‘ŠğŸ¼	oncoming fist, type-3
ğŸ‘ŠğŸ½	oncoming fist, type-4
ğŸ‘ŠğŸ¾	oncoming fist, type-5
ğŸ‘ŠğŸ¿	oncoming fist, type-6
ğŸ¤›	LEFT-FACING FIST
ğŸ¤›ğŸ»	left-facing fist, type-1-2
ğŸ¤›ğŸ¼	left-facing fist, type-3
ğŸ¤›ğŸ½	left-facing fist, type-4
ğŸ¤›ğŸ¾	left-facing fist, type-5
ğŸ¤›ğŸ¿	left-facing fist, type-6
ğŸ¤œ	RIGHT-FACING FIST
ğŸ¤œğŸ»	right-facing fist, type-1-2
ğŸ¤œğŸ¼	right-facing fist, type-3
ğŸ¤œğŸ½	right-facing fist, type-4
ğŸ¤œğŸ¾	right-facing fist, type-5
ğŸ¤œğŸ¿	right-facing fist, type-6
ğŸ¤š	RAISED BACK OF HAND
ğŸ¤šğŸ»	raised back of hand, type-1-2
ğŸ¤šğŸ¼	raised back of hand, type-3
ğŸ¤šğŸ½	raised back of hand, type-4
ğŸ¤šğŸ¾	raised back of hand, type-5
ğŸ¤šğŸ¿	raised back of hand, type-6
ğŸ‘‹	WAVING HAND SIGNâ‰Š waving hand
ğŸ‘‹ğŸ»	waving hand, type-1-2
ğŸ‘‹ğŸ¼	waving hand, type-3
ğŸ‘‹ğŸ½	waving hand, type-4
ğŸ‘‹ğŸ¾	waving hand, type-5
ğŸ‘‹ğŸ¿	waving hand, type-6
ğŸ‘	CLAPPING HANDS SIGNâ‰Š clapping hands
ğŸ‘ğŸ»	clapping hands, type-1-2
ğŸ‘ğŸ¼	clapping hands, type-3
ğŸ‘ğŸ½	clapping hands, type-4
ğŸ‘ğŸ¾	clapping hands, type-5
ğŸ‘ğŸ¿	clapping hands, type-6
âœ	WRITING HAND
âœğŸ»	writing hand, type-1-2
âœğŸ¼	writing hand, type-3
âœğŸ½	writing hand, type-4
âœğŸ¾	writing hand, type-5
âœğŸ¿	writing hand, type-6
ğŸ‘	OPEN HANDS SIGNâ‰Š open hands
ğŸ‘ğŸ»	open hands, type-1-2
ğŸ‘ğŸ¼	open hands, type-3
ğŸ‘ğŸ½	open hands, type-4
ğŸ‘ğŸ¾	open hands, type-5
ğŸ‘ğŸ¿	open hands, type-6
ğŸ™Œ	PERSON RAISING BOTH HANDS IN CELEBRATIONâ‰Š person raising hands
ğŸ™ŒğŸ»	person raising hands, type-1-2
ğŸ™ŒğŸ¼	person raising hands, type-3
ğŸ™ŒğŸ½	person raising hands, type-4
ğŸ™ŒğŸ¾	person raising hands, type-5
ğŸ™ŒğŸ¿	person raising hands, type-6
ğŸ™	PERSON WITH FOLDED HANDSâ‰Š folded hands
ğŸ™ğŸ»	folded hands, type-1-2
ğŸ™ğŸ¼	folded hands, type-3
ğŸ™ğŸ½	folded hands, type-4
ğŸ™ğŸ¾	folded hands, type-5
ğŸ™ğŸ¿	folded hands, type-6
ğŸ¤	HANDSHAKE
ğŸ¤ğŸ»	handshake, type-1-2
ğŸ¤ğŸ¼	handshake, type-3
ğŸ¤ğŸ½	handshake, type-4
ğŸ¤ğŸ¾	handshake, type-5
ğŸ¤ğŸ¿	handshake, type-6
ğŸ’…	NAIL POLISH
ğŸ’…ğŸ»	nail polish, type-1-2
ğŸ’…ğŸ¼	nail polish, type-3
ğŸ’…ğŸ½	nail polish, type-4
ğŸ’…ğŸ¾	nail polish, type-5
ğŸ’…ğŸ¿	nail polish, type-6
ğŸ‘‚	EAR
ğŸ‘‚ğŸ»	ear, type-1-2
ğŸ‘‚ğŸ¼	ear, type-3
ğŸ‘‚ğŸ½	ear, type-4
ğŸ‘‚ğŸ¾	ear, type-5
ğŸ‘‚ğŸ¿	ear, type-6
ğŸ‘ƒ	NOSE
ğŸ‘ƒğŸ»	nose, type-1-2
ğŸ‘ƒğŸ¼	nose, type-3
ğŸ‘ƒğŸ½	nose, type-4
ğŸ‘ƒğŸ¾	nose, type-5
ğŸ‘ƒğŸ¿	nose, type-6
ğŸ‘£	FOOTPRINTS
ğŸ‘€	EYES
ğŸ‘	EYE
ğŸ‘â€ğŸ—¨	eye, left speech bubble
ğŸ‘…	TONGUE
ğŸ‘„	MOUTH
ğŸ’‹	KISS MARK
ğŸ’˜	HEART WITH ARROW
â¤	HEAVY BLACK HEARTâ‰Š red heart
ğŸ’“	BEATING HEART
ğŸ’”	BROKEN HEART
ğŸ’•	TWO HEARTS
ğŸ’–	SPARKLING HEART
ğŸ’—	GROWING HEART
ğŸ’™	BLUE HEART
ğŸ’š	GREEN HEART
ğŸ’›	YELLOW HEART
ğŸ’œ	PURPLE HEART
ğŸ–¤	BLACK HEART
ğŸ’	HEART WITH RIBBON
ğŸ’	REVOLVING HEARTS
ğŸ’Ÿ	HEART DECORATION
â£	HEAVY HEART EXCLAMATION MARK ORNAMENTâ‰Š heavy heart exclamation
ğŸ’Œ	LOVE LETTER
ğŸ’¤	SLEEPING SYMBOLâ‰Š zzz
ğŸ’¢	ANGER SYMBOL
ğŸ’£	BOMB
ğŸ’¥	COLLISION SYMBOLâ‰Š collision
ğŸ’¦	SPLASHING SWEAT SYMBOLâ‰Š sweat droplets
ğŸ’¨	DASH SYMBOLâ‰Š dashing
ğŸ’«	DIZZY SYMBOLâ‰Š dizzy
ğŸ’¬	SPEECH BALLOON
ğŸ—¨	LEFT SPEECH BUBBLE
ğŸ—¯	RIGHT ANGER BUBBLE
ğŸ’­	THOUGHT BALLOON
ğŸ•³	HOLE
ğŸ‘“	EYEGLASSESâ‰Š glasses
ğŸ•¶	DARK SUNGLASSESâ‰Š sunglasses
ğŸ‘”	NECKTIE
ğŸ‘•	T-SHIRT
ğŸ‘–	JEANS
ğŸ‘—	DRESS
ğŸ‘˜	KIMONO
ğŸ‘™	BIKINI
ğŸ‘š	WOMANS CLOTHESâ‰Š womanâ€™s clothes
ğŸ‘›	PURSE
ğŸ‘œ	HANDBAG
ğŸ‘	POUCH
ğŸ›	SHOPPING BAGS
ğŸ’	SCHOOL SATCHELâ‰Š school backpack
ğŸ‘	MANS SHOEâ‰Š manâ€™s shoe
ğŸ‘Ÿ	ATHLETIC SHOEâ‰Š running shoe
ğŸ‘ 	HIGH-HEELED SHOE
ğŸ‘¡	WOMANS SANDALâ‰Š womanâ€™s sandal
ğŸ‘¢	WOMANS BOOTSâ‰Š womanâ€™s boot
ğŸ‘‘	CROWN
ğŸ‘’	WOMANS HATâ‰Š womanâ€™s hat
ğŸ©	TOP HAT
ğŸ“	GRADUATION CAP
â›‘	HELMET WITH WHITE CROSS
ğŸ“¿	PRAYER BEADS
ğŸ’„	LIPSTICK
ğŸ’	RING
ğŸ’	GEM STONE
ğŸµ	MONKEY FACE
ğŸ’	MONKEY
ğŸ¦	GORILLA
ğŸ¶	DOG FACE
ğŸ•	DOG
ğŸ©	POODLE
ğŸº	WOLF FACE
ğŸ¦Š	FOX FACE
ğŸ±	CAT FACE
ğŸˆ	CAT
ğŸ¦	LION FACE
ğŸ¯	TIGER FACE
ğŸ…	TIGER
ğŸ†	LEOPARD
ğŸ´	HORSE FACE
ğŸ	HORSE
ğŸ¦Œ	DEER
ğŸ¦„	UNICORN FACE
ğŸ®	COW FACE
ğŸ‚	OX
ğŸƒ	WATER BUFFALO
ğŸ„	COW
ğŸ·	PIG FACE
ğŸ–	PIG
ğŸ—	BOAR
ğŸ½	PIG NOSE
ğŸ	RAM
ğŸ‘	SHEEP
ğŸ	GOAT
ğŸª	DROMEDARY CAMELâ‰Š camel
ğŸ«	BACTRIAN CAMELâ‰Š two-hump camel
ğŸ˜	ELEPHANT
ğŸ¦	RHINOCEROS
ğŸ­	MOUSE FACE
ğŸ	MOUSE
ğŸ€	RAT
ğŸ¹	HAMSTER FACE
ğŸ°	RABBIT FACE
ğŸ‡	RABBIT
ğŸ¿	CHIPMUNK
ğŸ¦‡	BAT
ğŸ»	BEAR FACE
ğŸ¨	KOALA
ğŸ¼	PANDA FACE
ğŸ¾	PAW PRINTS
ğŸ¦ƒ	TURKEY
ğŸ”	CHICKEN
ğŸ“	ROOSTER
ğŸ£	HATCHING CHICK
ğŸ¤	BABY CHICK
ğŸ¥	FRONT-FACING BABY CHICK
ğŸ¦	BIRD
ğŸ§	PENGUIN
ğŸ•Š	DOVE OF PEACEâ‰Š dove
ğŸ¦…	EAGLE
ğŸ¦†	DUCK
ğŸ¦‰	OWL
ğŸ¸	FROG FACE
ğŸŠ	CROCODILE
ğŸ¢	TURTLE
ğŸ¦	LIZARD
ğŸ	SNAKE
ğŸ²	DRAGON FACE
ğŸ‰	DRAGON
ğŸ³	SPOUTING WHALE
ğŸ‹	WHALE
ğŸ¬	DOLPHIN
ğŸŸ	FISH
ğŸ 	TROPICAL FISH
ğŸ¡	BLOWFISH
ğŸ¦ˆ	SHARK
ğŸ™	OCTOPUS
ğŸš	SPIRAL SHELL
ğŸ¦€	CRAB
ğŸ¦	SHRIMP
ğŸ¦‘	SQUID
ğŸ¦‹	BUTTERFLY
ğŸŒ	SNAIL
ğŸ›	BUG
ğŸœ	ANT
ğŸ	HONEYBEE
ğŸ	LADY BEETLE
ğŸ•·	SPIDER
ğŸ•¸	SPIDER WEB
ğŸ¦‚	SCORPION
ğŸ’	BOUQUET
ğŸŒ¸	CHERRY BLOSSOM
ğŸ’®	WHITE FLOWER
ğŸµ	ROSETTE
ğŸŒ¹	ROSE
ğŸ¥€	WILTED FLOWER
ğŸŒº	HIBISCUS
ğŸŒ»	SUNFLOWER
ğŸŒ¼	BLOSSOM
ğŸŒ·	TULIP
ğŸŒ±	SEEDLING
ğŸŒ²	EVERGREEN TREEâ‰Š evergreen
ğŸŒ³	DECIDUOUS TREE
ğŸŒ´	PALM TREE
ğŸŒµ	CACTUS
ğŸŒ¾	EAR OF RICEâ‰Š sheaf of rice
ğŸŒ¿	HERB
â˜˜	SHAMROCK
ğŸ€	FOUR LEAF CLOVER
ğŸ	MAPLE LEAF
ğŸ‚	FALLEN LEAF
ğŸƒ	LEAF FLUTTERING IN WIND
ğŸ‡	GRAPES
ğŸˆ	MELON
ğŸ‰	WATERMELON
ğŸŠ	TANGERINE
ğŸ‹	LEMON
ğŸŒ	BANANA
ğŸ	PINEAPPLE
ğŸ	RED APPLE
ğŸ	GREEN APPLE
ğŸ	PEAR
ğŸ‘	PEACH
ğŸ’	CHERRIES
ğŸ“	STRAWBERRY
ğŸ¥	KIWIFRUIT
ğŸ…	TOMATO
ğŸ¥‘	AVOCADO
ğŸ†	AUBERGINEâ‰Š eggplant
ğŸ¥”	POTATO
ğŸ¥•	CARROT
ğŸŒ½	EAR OF MAIZEâ‰Š ear of corn
ğŸŒ¶	HOT PEPPER
ğŸ¥’	CUCUMBER
ğŸ„	MUSHROOM
ğŸ¥œ	PEANUTS
ğŸŒ°	CHESTNUT
ğŸ	BREAD
ğŸ¥	CROISSANT
ğŸ¥–	BAGUETTE BREAD
ğŸ¥	PANCAKES
ğŸ§€	CHEESE WEDGE
ğŸ–	MEAT ON BONE
ğŸ—	POULTRY LEG
ğŸ¥“	BACON
ğŸ”	HAMBURGER
ğŸŸ	FRENCH FRIES
ğŸ•	SLICE OF PIZZAâ‰Š pizza
ğŸŒ­	HOT DOG
ğŸŒ®	TACO
ğŸŒ¯	BURRITO
ğŸ¥™	STUFFED FLATBREAD
ğŸ¥š	EGG
ğŸ³	COOKING
ğŸ¥˜	SHALLOW PAN OF FOOD
ğŸ²	POT OF FOOD
ğŸ¥—	GREEN SALAD
ğŸ¿	POPCORN
ğŸ±	BENTO BOX
ğŸ˜	RICE CRACKER
ğŸ™	RICE BALL
ğŸš	COOKED RICE
ğŸ›	CURRY AND RICEâ‰Š curry rice
ğŸœ	STEAMING BOWL
ğŸ	SPAGHETTI
ğŸ 	ROASTED SWEET POTATO
ğŸ¢	ODEN
ğŸ£	SUSHI
ğŸ¤	FRIED SHRIMP
ğŸ¥	FISH CAKE WITH SWIRL DESIGNâ‰Š fish cake with swirl
ğŸ¡	DANGO
ğŸ¦	SOFT ICE CREAM
ğŸ§	SHAVED ICE
ğŸ¨	ICE CREAM
ğŸ©	DOUGHNUT
ğŸª	COOKIE
ğŸ‚	BIRTHDAY CAKE
ğŸ°	SHORTCAKE
ğŸ«	CHOCOLATE BAR
ğŸ¬	CANDY
ğŸ­	LOLLIPOP
ğŸ®	CUSTARD
ğŸ¯	HONEY POT
ğŸ¼	BABY BOTTLE
ğŸ¥›	GLASS OF MILK
â˜•	HOT BEVERAGE
ğŸµ	TEACUP WITHOUT HANDLE
ğŸ¶	SAKE BOTTLE AND CUPâ‰Š sake
ğŸ¾	BOTTLE WITH POPPING CORK
ğŸ·	WINE GLASS
ğŸ¸	COCKTAIL GLASS
ğŸ¹	TROPICAL DRINK
ğŸº	BEER MUG
ğŸ»	CLINKING BEER MUGS
ğŸ¥‚	CLINKING GLASSES
ğŸ¥ƒ	TUMBLER GLASS
ğŸ½	FORK AND KNIFE WITH PLATE
ğŸ´	FORK AND KNIFE
ğŸ¥„	SPOON
ğŸ”ª	HOCHOâ‰Š kitchen knife
ğŸº	AMPHORA
ğŸŒ	EARTH GLOBE EUROPE-AFRICAâ‰Š globe showing europe-africa
ğŸŒ	EARTH GLOBE AMERICASâ‰Š globe showing americas
ğŸŒ	EARTH GLOBE ASIA-AUSTRALIAâ‰Š globe showing asia-australia
ğŸŒ	GLOBE WITH MERIDIANS
ğŸ—º	WORLD MAP
ğŸ—¾	SILHOUETTE OF JAPANâ‰Š map of japan
ğŸ”	SNOW CAPPED MOUNTAINâ‰Š snow-capped mountain
â›°	MOUNTAIN
ğŸŒ‹	VOLCANO
ğŸ—»	MOUNT FUJI
ğŸ•	CAMPING
ğŸ–	BEACH WITH UMBRELLA
ğŸœ	DESERT
ğŸ	DESERT ISLAND
ğŸ	NATIONAL PARK
ğŸŸ	STADIUM
ğŸ›	CLASSICAL BUILDING
ğŸ—	BUILDING CONSTRUCTION
ğŸ˜	HOUSE BUILDINGS
ğŸ™	CITYSCAPE
ğŸš	DERELICT HOUSE BUILDING
ğŸ 	HOUSE BUILDING
ğŸ¡	HOUSE WITH GARDEN
ğŸ¢	OFFICE BUILDING
ğŸ£	JAPANESE POST OFFICE
ğŸ¤	EUROPEAN POST OFFICEâ‰Š post office
ğŸ¥	HOSPITAL
ğŸ¦	BANK
ğŸ¨	HOTEL
ğŸ©	LOVE HOTEL
ğŸª	CONVENIENCE STORE
ğŸ«	SCHOOL
ğŸ¬	DEPARTMENT STORE
ğŸ­	FACTORY
ğŸ¯	JAPANESE CASTLE
ğŸ°	EUROPEAN CASTLEâ‰Š castle
ğŸ’’	WEDDING
ğŸ—¼	TOKYO TOWER
ğŸ—½	STATUE OF LIBERTY
â›ª	CHURCH
ğŸ•Œ	MOSQUE
ğŸ•	SYNAGOGUE
â›©	SHINTO SHRINE
ğŸ•‹	KAABA
â›²	FOUNTAIN
â›º	TENT
ğŸŒ	FOGGY
ğŸŒƒ	NIGHT WITH STARS
ğŸŒ„	SUNRISE OVER MOUNTAINS
ğŸŒ…	SUNRISE
ğŸŒ†	CITYSCAPE AT DUSK
ğŸŒ‡	SUNSET OVER BUILDINGSâ‰Š sunset
ğŸŒ‰	BRIDGE AT NIGHT
â™¨	HOT SPRINGS
ğŸŒŒ	MILKY WAY
ğŸ 	CAROUSEL HORSE
ğŸ¡	FERRIS WHEEL
ğŸ¢	ROLLER COASTER
ğŸ’ˆ	BARBER POLE
ğŸª	CIRCUS TENT
ğŸ­	PERFORMING ARTS
ğŸ–¼	FRAME WITH PICTURE
ğŸ¨	ARTIST PALETTE
ğŸ°	SLOT MACHINE
ğŸš‚	STEAM LOCOMOTIVEâ‰Š locomotive
ğŸšƒ	RAILWAY CAR
ğŸš„	HIGH-SPEED TRAIN
ğŸš…	HIGH-SPEED TRAIN WITH BULLET NOSE
ğŸš†	TRAIN
ğŸš‡	METRO
ğŸšˆ	LIGHT RAIL
ğŸš‰	STATION
ğŸšŠ	TRAM
ğŸš	MONORAIL
ğŸš	MOUNTAIN RAILWAY
ğŸš‹	TRAM CAR
ğŸšŒ	BUS
ğŸš	ONCOMING BUS
ğŸš	TROLLEYBUS
ğŸš	MINIBUS
ğŸš‘	AMBULANCE
ğŸš’	FIRE ENGINE
ğŸš“	POLICE CAR
ğŸš”	ONCOMING POLICE CAR
ğŸš•	TAXI
ğŸš–	ONCOMING TAXI
ğŸš—	AUTOMOBILE
ğŸš˜	ONCOMING AUTOMOBILE
ğŸš™	RECREATIONAL VEHICLE
ğŸšš	DELIVERY TRUCK
ğŸš›	ARTICULATED LORRY
ğŸšœ	TRACTOR
ğŸš²	BICYCLE
ğŸ›´	SCOOTERâ‰Š kick scooter
ğŸ›µ	MOTOR SCOOTER
ğŸ	RACING CAR
ğŸ	RACING MOTORCYCLEâ‰Š motorcycle
ğŸš	BUS STOP
ğŸ›£	MOTORWAY
ğŸ›¤	RAILWAY TRACK
â›½	FUEL PUMP
ğŸš¨	POLICE CARS REVOLVING LIGHTâ‰Š police carâ€™s light
ğŸš¥	HORIZONTAL TRAFFIC LIGHT
ğŸš¦	VERTICAL TRAFFIC LIGHT
ğŸš§	CONSTRUCTION SIGNâ‰Š construction
ğŸ›‘	OCTAGONAL SIGNâ‰Š stop sign
âš“	ANCHOR
â›µ	SAILBOAT
ğŸ›¶	CANOE
ğŸš¤	SPEEDBOAT
ğŸ›³	PASSENGER SHIP
â›´	FERRY
ğŸ›¥	MOTOR BOAT
ğŸš¢	SHIP
âœˆ	AIRPLANE
ğŸ›©	SMALL AIRPLANE
ğŸ›«	AIRPLANE DEPARTURE
ğŸ›¬	AIRPLANE ARRIVINGâ‰Š airplane arrival
ğŸ’º	SEAT
ğŸš	HELICOPTER
ğŸšŸ	SUSPENSION RAILWAY
ğŸš 	MOUNTAIN CABLEWAY
ğŸš¡	AERIAL TRAMWAY
ğŸš€	ROCKET
ğŸ›°	SATELLITE
ğŸ›	BELLHOP BELL
ğŸšª	DOOR
ğŸ›Œ	SLEEPING ACCOMMODATIONâ‰Š person in bed
ğŸ›	BED
ğŸ›‹	COUCH AND LAMP
ğŸš½	TOILET
ğŸš¿	SHOWER
ğŸ›€	BATHâ‰Š person taking bath
ğŸ›€ğŸ»	person taking bath, type-1-2
ğŸ›€ğŸ¼	person taking bath, type-3
ğŸ›€ğŸ½	person taking bath, type-4
ğŸ›€ğŸ¾	person taking bath, type-5
ğŸ›€ğŸ¿	person taking bath, type-6
ğŸ›	BATHTUB
âŒ›	HOURGLASS
â³	HOURGLASS WITH FLOWING SAND
âŒš	WATCH
â°	ALARM CLOCK
â±	STOPWATCH
â²	TIMER CLOCK
ğŸ•°	MANTELPIECE CLOCK
ğŸ•›	CLOCK FACE TWELVE OCLOCKâ‰Š twelve oâ€™clock
ğŸ•§	CLOCK FACE TWELVE-THIRTYâ‰Š twelve-thirty
ğŸ•	CLOCK FACE ONE OCLOCKâ‰Š one oâ€™clock
ğŸ•œ	CLOCK FACE ONE-THIRTYâ‰Š one-thirty
ğŸ•‘	CLOCK FACE TWO OCLOCKâ‰Š two oâ€™clock
ğŸ•	CLOCK FACE TWO-THIRTYâ‰Š two-thirty
ğŸ•’	CLOCK FACE THREE OCLOCKâ‰Š three oâ€™clock
ğŸ•	CLOCK FACE THREE-THIRTYâ‰Š three-thirty
ğŸ•“	CLOCK FACE FOUR OCLOCKâ‰Š four oâ€™clock
ğŸ•Ÿ	CLOCK FACE FOUR-THIRTYâ‰Š four-thirty
ğŸ•”	CLOCK FACE FIVE OCLOCKâ‰Š five oâ€™clock
ğŸ• 	CLOCK FACE FIVE-THIRTYâ‰Š five-thirty
ğŸ••	CLOCK FACE SIX OCLOCKâ‰Š six oâ€™clock
ğŸ•¡	CLOCK FACE SIX-THIRTYâ‰Š six-thirty
ğŸ•–	CLOCK FACE SEVEN OCLOCKâ‰Š seven oâ€™clock
ğŸ•¢	CLOCK FACE SEVEN-THIRTYâ‰Š seven-thirty
ğŸ•—	CLOCK FACE EIGHT OCLOCKâ‰Š eight oâ€™clock
ğŸ•£	CLOCK FACE EIGHT-THIRTYâ‰Š eight-thirty
ğŸ•˜	CLOCK FACE NINE OCLOCKâ‰Š nine oâ€™clock
ğŸ•¤	CLOCK FACE NINE-THIRTYâ‰Š nine-thirty
ğŸ•™	CLOCK FACE TEN OCLOCKâ‰Š ten oâ€™clock
ğŸ•¥	CLOCK FACE TEN-THIRTYâ‰Š ten-thirty
ğŸ•š	CLOCK FACE ELEVEN OCLOCKâ‰Š eleven oâ€™clock
ğŸ•¦	CLOCK FACE ELEVEN-THIRTYâ‰Š eleven-thirty
ğŸŒ‘	NEW MOON SYMBOLâ‰Š new moon
ğŸŒ’	WAXING CRESCENT MOON SYMBOLâ‰Š waxing crescent moon
ğŸŒ“	FIRST QUARTER MOON SYMBOLâ‰Š first quarter moon
ğŸŒ”	WAXING GIBBOUS MOON SYMBOLâ‰Š waxing gibbous moon
ğŸŒ•	FULL MOON SYMBOLâ‰Š full moon
ğŸŒ–	WANING GIBBOUS MOON SYMBOLâ‰Š waning gibbous moon
ğŸŒ—	LAST QUARTER MOON SYMBOLâ‰Š last quarter moon
ğŸŒ˜	WANING CRESCENT MOON SYMBOLâ‰Š waning crescent moon
ğŸŒ™	CRESCENT MOON
ğŸŒš	NEW MOON WITH FACEâ‰Š new moon face
ğŸŒ›	FIRST QUARTER MOON WITH FACE
ğŸŒœ	LAST QUARTER MOON WITH FACE
ğŸŒ¡	THERMOMETER
â˜€	BLACK SUN WITH RAYSâ‰Š sun
ğŸŒ	FULL MOON WITH FACE
ğŸŒ	SUN WITH FACE
â­	WHITE MEDIUM STAR
ğŸŒŸ	GLOWING STAR
ğŸŒ 	SHOOTING STAR
â˜	CLOUD
â›…	SUN BEHIND CLOUD
â›ˆ	THUNDER CLOUD AND RAINâ‰Š cloud with lightning and rain
ğŸŒ¤	WHITE SUN WITH SMALL CLOUDâ‰Š sun behind small cloud
ğŸŒ¥	WHITE SUN BEHIND CLOUDâ‰Š sun behind large cloud
ğŸŒ¦	WHITE SUN BEHIND CLOUD WITH RAINâ‰Š sun behind cloud with rain
ğŸŒ§	CLOUD WITH RAIN
ğŸŒ¨	CLOUD WITH SNOW
ğŸŒ©	CLOUD WITH LIGHTNING
ğŸŒª	CLOUD WITH TORNADOâ‰Š tornado
ğŸŒ«	FOG
ğŸŒ¬	WIND BLOWING FACEâ‰Š wind face
ğŸŒ€	CYCLONE
ğŸŒˆ	RAINBOW
ğŸŒ‚	CLOSED UMBRELLA
â˜‚	UMBRELLA
â˜”	UMBRELLA WITH RAIN DROPS
â›±	UMBRELLA ON GROUND
âš¡	HIGH VOLTAGE SIGNâ‰Š high voltage
â„	SNOWFLAKE
â˜ƒ	SNOWMAN
â›„	SNOWMAN WITHOUT SNOW
â˜„	COMET
ğŸ”¥	FIRE
ğŸ’§	DROPLET
ğŸŒŠ	WATER WAVE
ğŸƒ	JACK-O-LANTERN
ğŸ„	CHRISTMAS TREE
ğŸ†	FIREWORKS
ğŸ‡	FIREWORK SPARKLERâ‰Š sparkler
âœ¨	SPARKLES
ğŸˆ	BALLOON
ğŸ‰	PARTY POPPER
ğŸŠ	CONFETTI BALL
ğŸ‹	TANABATA TREE
ğŸ	PINE DECORATION
ğŸ	JAPANESE DOLLS
ğŸ	CARP STREAMER
ğŸ	WIND CHIME
ğŸ‘	MOON VIEWING CEREMONYâ‰Š moon ceremony
ğŸ€	RIBBON
ğŸ	WRAPPED PRESENT
ğŸ—	REMINDER RIBBON
ğŸŸ	ADMISSION TICKETS
ğŸ«	TICKET
ğŸ–	MILITARY MEDAL
ğŸ†	TROPHY
ğŸ…	SPORTS MEDAL
ğŸ¥‡	FIRST PLACE MEDALâ‰Š 1st place medal
ğŸ¥ˆ	SECOND PLACE MEDALâ‰Š 2nd place medal
ğŸ¥‰	THIRD PLACE MEDALâ‰Š 3rd place medal
âš½	SOCCER BALL
âš¾	BASEBALL
ğŸ€	BASKETBALL AND HOOPâ‰Š basketball
ğŸ	VOLLEYBALL
ğŸˆ	AMERICAN FOOTBALL
ğŸ‰	RUGBY FOOTBALL
ğŸ¾	TENNIS RACQUET AND BALLâ‰Š tennis
ğŸ±	BILLIARDS
ğŸ³	BOWLING
ğŸ	CRICKET BAT AND BALLâ‰Š cricket
ğŸ‘	FIELD HOCKEY STICK AND BALLâ‰Š field hockey
ğŸ’	ICE HOCKEY STICK AND PUCK
ğŸ“	TABLE TENNIS PADDLE AND BALLâ‰Š ping pong
ğŸ¸	BADMINTON RACQUET AND SHUTTLECOCKâ‰Š badminton
ğŸ¥Š	BOXING GLOVE
ğŸ¥‹	MARTIAL ARTS UNIFORM
ğŸ¥…	GOAL NET
ğŸ¯	DIRECT HIT
â›³	FLAG IN HOLE
â›¸	ICE SKATE
ğŸ£	FISHING POLE AND FISHâ‰Š fishing pole
ğŸ½	RUNNING SHIRT WITH SASHâ‰Š running shirt
ğŸ¿	SKI AND SKI BOOTâ‰Š skis
ğŸ¤º	FENCERâ‰Š person fencing
ğŸ‡	HORSE RACING
â›·	SKIER
ğŸ‚	SNOWBOARDER
ğŸŒ	GOLFERâ‰Š person golfing
ğŸ„	SURFERâ‰Š person surfing
ğŸ„ğŸ»	person surfing, type-1-2
ğŸ„ğŸ¼	person surfing, type-3
ğŸ„ğŸ½	person surfing, type-4
ğŸ„ğŸ¾	person surfing, type-5
ğŸ„ğŸ¿	person surfing, type-6
ğŸš£	ROWBOATâ‰Š person rowing boat
ğŸš£ğŸ»	person rowing boat, type-1-2
ğŸš£ğŸ¼	person rowing boat, type-3
ğŸš£ğŸ½	person rowing boat, type-4
ğŸš£ğŸ¾	person rowing boat, type-5
ğŸš£ğŸ¿	person rowing boat, type-6
ğŸŠ	SWIMMERâ‰Š person swimming
ğŸŠğŸ»	person swimming, type-1-2
ğŸŠğŸ¼	person swimming, type-3
ğŸŠğŸ½	person swimming, type-4
ğŸŠğŸ¾	person swimming, type-5
ğŸŠğŸ¿	person swimming, type-6
â›¹	PERSON WITH BALL
â›¹ğŸ»	person with ball, type-1-2
â›¹ğŸ¼	person with ball, type-3
â›¹ğŸ½	person with ball, type-4
â›¹ğŸ¾	person with ball, type-5
â›¹ğŸ¿	person with ball, type-6
ğŸ‹	WEIGHT LIFTERâ‰Š person weight lifting
ğŸ‹ğŸ»	person weight lifting, type-1-2
ğŸ‹ğŸ¼	person weight lifting, type-3
ğŸ‹ğŸ½	person weight lifting, type-4
ğŸ‹ğŸ¾	person weight lifting, type-5
ğŸ‹ğŸ¿	person weight lifting, type-6
ğŸš´	BICYCLISTâ‰Š person biking
ğŸš´ğŸ»	person biking, type-1-2
ğŸš´ğŸ¼	person biking, type-3
ğŸš´ğŸ½	person biking, type-4
ğŸš´ğŸ¾	person biking, type-5
ğŸš´ğŸ¿	person biking, type-6
ğŸšµ	MOUNTAIN BICYCLISTâ‰Š person mountain biking
ğŸšµğŸ»	person mountain biking, type-1-2
ğŸšµğŸ¼	person mountain biking, type-3
ğŸšµğŸ½	person mountain biking, type-4
ğŸšµğŸ¾	person mountain biking, type-5
ğŸšµğŸ¿	person mountain biking, type-6
ğŸ¤¸	PERSON DOING CARTWHEEL
ğŸ¤¸ğŸ»	person doing cartwheel, type-1-2
ğŸ¤¸ğŸ¼	person doing cartwheel, type-3
ğŸ¤¸ğŸ½	person doing cartwheel, type-4
ğŸ¤¸ğŸ¾	person doing cartwheel, type-5
ğŸ¤¸ğŸ¿	person doing cartwheel, type-6
ğŸ¤¼	WRESTLERSâ‰Š people wrestling
ğŸ¤¼ğŸ»	people wrestling, type-1-2
ğŸ¤¼ğŸ¼	people wrestling, type-3
ğŸ¤¼ğŸ½	people wrestling, type-4
ğŸ¤¼ğŸ¾	people wrestling, type-5
ğŸ¤¼ğŸ¿	people wrestling, type-6
ğŸ¤½	WATER POLOâ‰Š person playing water polo
ğŸ¤½ğŸ»	person playing water polo, type-1-2
ğŸ¤½ğŸ¼	person playing water polo, type-3
ğŸ¤½ğŸ½	person playing water polo, type-4
ğŸ¤½ğŸ¾	person playing water polo, type-5
ğŸ¤½ğŸ¿	person playing water polo, type-6
ğŸ¤¾	HANDBALLâ‰Š person playing handball
ğŸ¤¾ğŸ»	person playing handball, type-1-2
ğŸ¤¾ğŸ¼	person playing handball, type-3
ğŸ¤¾ğŸ½	person playing handball, type-4
ğŸ¤¾ğŸ¾	person playing handball, type-5
ğŸ¤¾ğŸ¿	person playing handball, type-6
ğŸ¤¹	JUGGLINGâ‰Š person juggling
ğŸ¤¹ğŸ»	person juggling, type-1-2
ğŸ¤¹ğŸ¼	person juggling, type-3
ğŸ¤¹ğŸ½	person juggling, type-4
ğŸ¤¹ğŸ¾	person juggling, type-5
ğŸ¤¹ğŸ¿	person juggling, type-6
ğŸ®	VIDEO GAME
ğŸ•¹	JOYSTICK
ğŸ²	GAME DIE
â™ 	BLACK SPADE SUITâ‰Š spade suit
â™¥	BLACK HEART SUITâ‰Š heart suit
â™¦	BLACK DIAMOND SUITâ‰Š diamond suit
â™£	BLACK CLUB SUITâ‰Š club suit
ğŸƒ	PLAYING CARD BLACK JOKERâ‰Š joker
ğŸ€„	MAHJONG TILE RED DRAGONâ‰Š mahjong red dragon
ğŸ´	FLOWER PLAYING CARDS
ğŸ”‡	SPEAKER WITH CANCELLATION STROKEâ‰Š speaker off
ğŸ”ˆ	SPEAKER
ğŸ”‰	SPEAKER WITH ONE SOUND WAVEâ‰Š speaker on
ğŸ”Š	SPEAKER WITH THREE SOUND WAVESâ‰Š speaker loud
ğŸ“¢	PUBLIC ADDRESS LOUDSPEAKERâ‰Š loudspeaker
ğŸ“£	CHEERING MEGAPHONEâ‰Š megaphone
ğŸ“¯	POSTAL HORN
ğŸ””	BELL
ğŸ”•	BELL WITH CANCELLATION STROKEâ‰Š bell with slash
ğŸ¼	MUSICAL SCORE
ğŸµ	MUSICAL NOTE
ğŸ¶	MULTIPLE MUSICAL NOTESâ‰Š musical notes
ğŸ™	STUDIO MICROPHONE
ğŸš	LEVEL SLIDER
ğŸ›	CONTROL KNOBS
ğŸ¤	MICROPHONE
ğŸ§	HEADPHONE
ğŸ“»	RADIO
ğŸ·	SAXOPHONE
ğŸ¸	GUITAR
ğŸ¹	MUSICAL KEYBOARD
ğŸº	TRUMPET
ğŸ»	VIOLIN
ğŸ¥	DRUM WITH DRUMSTICKSâ‰Š drum
ğŸ“±	MOBILE PHONE
ğŸ“²	MOBILE PHONE WITH RIGHTWARDS ARROW AT LEFTâ‰Š mobile phone with arrow
â˜	BLACK TELEPHONEâ‰Š telephone
ğŸ“	TELEPHONE RECEIVER
ğŸ“Ÿ	PAGER
ğŸ“ 	FAX MACHINE
ğŸ”‹	BATTERY
ğŸ”Œ	ELECTRIC PLUG
ğŸ’»	PERSONAL COMPUTERâ‰Š laptop computer
ğŸ–¥	DESKTOP COMPUTER
ğŸ–¨	PRINTER
âŒ¨	KEYBOARD
ğŸ–±	THREE BUTTON MOUSEâ‰Š computer mouse
ğŸ–²	TRACKBALL
ğŸ’½	MINIDISC
ğŸ’¾	FLOPPY DISK
ğŸ’¿	OPTICAL DISC
ğŸ“€	DVD
ğŸ¥	MOVIE CAMERA
ğŸ	FILM FRAMES
ğŸ“½	FILM PROJECTOR
ğŸ¬	CLAPPER BOARD
ğŸ“º	TELEVISION
ğŸ“·	CAMERA
ğŸ“¸	CAMERA WITH FLASH
ğŸ“¹	VIDEO CAMERA
ğŸ“¼	VIDEOCASSETTE
ğŸ”	LEFT-POINTING MAGNIFYING GLASS
ğŸ”	RIGHT-POINTING MAGNIFYING GLASS
ğŸ”¬	MICROSCOPE
ğŸ”­	TELESCOPE
ğŸ“¡	SATELLITE ANTENNA
ğŸ•¯	CANDLE
ğŸ’¡	ELECTRIC LIGHT BULBâ‰Š light bulb
ğŸ”¦	ELECTRIC TORCHâ‰Š flashlight
ğŸ®	IZAKAYA LANTERNâ‰Š red paper lantern
ğŸ“”	NOTEBOOK WITH DECORATIVE COVER
ğŸ“•	CLOSED BOOK
ğŸ“–	OPEN BOOK
ğŸ“—	GREEN BOOK
ğŸ“˜	BLUE BOOK
ğŸ“™	ORANGE BOOK
ğŸ“š	BOOKS
ğŸ““	NOTEBOOK
ğŸ“’	LEDGER
ğŸ“ƒ	PAGE WITH CURL
ğŸ“œ	SCROLL
ğŸ“„	PAGE FACING UP
ğŸ“°	NEWSPAPER
ğŸ—	ROLLED-UP NEWSPAPER
ğŸ“‘	BOOKMARK TABS
ğŸ”–	BOOKMARK
ğŸ·	LABEL
ğŸ’°	MONEY BAG
ğŸ’´	BANKNOTE WITH YEN SIGNâ‰Š yen banknote
ğŸ’µ	BANKNOTE WITH DOLLAR SIGNâ‰Š dollar banknote
ğŸ’¶	BANKNOTE WITH EURO SIGNâ‰Š euro banknote
ğŸ’·	BANKNOTE WITH POUND SIGNâ‰Š pound banknote
ğŸ’¸	MONEY WITH WINGS
ğŸ’³	CREDIT CARD
ğŸ’¹	CHART WITH UPWARDS TREND AND YEN SIGNâ‰Š chart increasing with yen
ğŸ’±	CURRENCY EXCHANGE
ğŸ’²	HEAVY DOLLAR SIGN
âœ‰	ENVELOPE
ğŸ“§	E-MAIL SYMBOLâ‰Š e-mail
ğŸ“¨	INCOMING ENVELOPE
ğŸ“©	ENVELOPE WITH DOWNWARDS ARROW ABOVEâ‰Š envelope with arrow
ğŸ“¤	OUTBOX TRAY
ğŸ“¥	INBOX TRAY
ğŸ“¦	PACKAGE
ğŸ“«	CLOSED MAILBOX WITH RAISED FLAG
ğŸ“ª	CLOSED MAILBOX WITH LOWERED FLAG
ğŸ“¬	OPEN MAILBOX WITH RAISED FLAG
ğŸ“­	OPEN MAILBOX WITH LOWERED FLAG
ğŸ“®	POSTBOX
ğŸ—³	BALLOT BOX WITH BALLOT
âœ	PENCIL
âœ’	BLACK NIB
ğŸ–‹	LOWER LEFT FOUNTAIN PENâ‰Š fountain pen
ğŸ–Š	LOWER LEFT BALLPOINT PENâ‰Š pen
ğŸ–Œ	LOWER LEFT PAINTBRUSHâ‰Š paintbrush
ğŸ–	LOWER LEFT CRAYONâ‰Š crayon
ğŸ“	MEMO
ğŸ’¼	BRIEFCASE
ğŸ“	FILE FOLDER
ğŸ“‚	OPEN FILE FOLDER
ğŸ—‚	CARD INDEX DIVIDERS
ğŸ“…	CALENDAR
ğŸ“†	TEAR-OFF CALENDAR
ğŸ—’	SPIRAL NOTE PADâ‰Š spiral notepad
ğŸ—“	SPIRAL CALENDAR PADâ‰Š spiral calendar
ğŸ“‡	CARD INDEX
ğŸ“ˆ	CHART WITH UPWARDS TRENDâ‰Š chart increasing
ğŸ“‰	CHART WITH DOWNWARDS TRENDâ‰Š chart decreasing
ğŸ“Š	BAR CHART
ğŸ“‹	CLIPBOARD
ğŸ“Œ	PUSHPIN
ğŸ“	ROUND PUSHPIN
ğŸ“	PAPERCLIP
ğŸ–‡	LINKED PAPERCLIPS
ğŸ“	STRAIGHT RULER
ğŸ“	TRIANGULAR RULER
âœ‚	BLACK SCISSORSâ‰Š scissors
ğŸ—ƒ	CARD FILE BOX
ğŸ—„	FILE CABINET
ğŸ—‘	WASTEBASKET
ğŸ”’	LOCK
ğŸ”“	OPEN LOCK
ğŸ”	LOCK WITH INK PENâ‰Š lock with pen
ğŸ”	CLOSED LOCK WITH KEY
ğŸ”‘	KEY
ğŸ—	OLD KEY
ğŸ”¨	HAMMER
â›	PICK
âš’	HAMMER AND PICK
ğŸ› 	HAMMER AND WRENCH
ğŸ—¡	DAGGER KNIFEâ‰Š dagger
âš”	CROSSED SWORDS
ğŸ”«	PISTOL
ğŸ¹	BOW AND ARROW
ğŸ›¡	SHIELD
ğŸ”§	WRENCH
ğŸ”©	NUT AND BOLT
âš™	GEAR
ğŸ—œ	COMPRESSION
âš—	ALEMBIC
âš–	SCALESâ‰Š balance scale
ğŸ”—	LINK SYMBOLâ‰Š link
â›“	CHAINS
ğŸ’‰	SYRINGE
ğŸ’Š	PILL
ğŸš¬	SMOKING SYMBOLâ‰Š smoking
âš°	COFFIN
âš±	FUNERAL URN
ğŸ—¿	MOYAIâ‰Š moai
ğŸ›¢	OIL DRUM
ğŸ”®	CRYSTAL BALL
ğŸ›’	SHOPPING TROLLEYâ‰Š shopping cart
ğŸ§	AUTOMATED TELLER MACHINEâ‰Š ATM sign
ğŸš®	PUT LITTER IN ITS PLACE SYMBOLâ‰Š litter in bin sign
ğŸš°	POTABLE WATER SYMBOLâ‰Š potable water
â™¿	WHEELCHAIR SYMBOLâ‰Š wheelchair
ğŸš¹	MENS SYMBOLâ‰Š menâ€™s room
ğŸšº	WOMENS SYMBOLâ‰Š womenâ€™s room
ğŸš»	RESTROOM
ğŸš¼	BABY SYMBOL
ğŸš¾	WATER CLOSET
ğŸ›‚	PASSPORT CONTROL
ğŸ›ƒ	CUSTOMS
ğŸ›„	BAGGAGE CLAIM
ğŸ›…	LEFT LUGGAGE
âš 	WARNING SIGNâ‰Š warning
ğŸš¸	CHILDREN CROSSING
â›”	NO ENTRY
ğŸš«	NO ENTRY SIGNâ‰Š prohibited
ğŸš³	NO BICYCLES
ğŸš­	NO SMOKING SYMBOLâ‰Š no smoking
ğŸš¯	DO NOT LITTER SYMBOLâ‰Š no littering
ğŸš±	NON-POTABLE WATER SYMBOLâ‰Š non-potable water
ğŸš·	NO PEDESTRIANS
ğŸ“µ	NO MOBILE PHONES
ğŸ”	NO ONE UNDER EIGHTEEN SYMBOLâ‰Š no one under eighteen
â˜¢	RADIOACTIVE SIGNâ‰Š radioactive
â˜£	BIOHAZARD SIGNâ‰Š biohazard
â¬†	UPWARDS BLACK ARROWâ‰Š up arrow
â†—	NORTH EAST ARROWâ‰Š up-right arrow
â¡	BLACK RIGHTWARDS ARROWâ‰Š right arrow
â†˜	SOUTH EAST ARROWâ‰Š down-right arrow
â¬‡	DOWNWARDS BLACK ARROWâ‰Š down arrow
â†™	SOUTH WEST ARROWâ‰Š down-left arrow
â¬…	LEFTWARDS BLACK ARROWâ‰Š left arrow
â†–	NORTH WEST ARROWâ‰Š up-left arrow
â†•	UP DOWN ARROWâ‰Š up-down arrow
â†”	LEFT RIGHT ARROWâ‰Š left-right arrow
â†©	LEFTWARDS ARROW WITH HOOKâ‰Š right arrow curving left
â†ª	RIGHTWARDS ARROW WITH HOOKâ‰Š left arrow curving right
â¤´	ARROW POINTING RIGHTWARDS THEN CURVING UPWARDSâ‰Š right arrow curving up
â¤µ	ARROW POINTING RIGHTWARDS THEN CURVING DOWNWARDSâ‰Š right arrow curving down
ğŸ”ƒ	CLOCKWISE DOWNWARDS AND UPWARDS OPEN CIRCLE ARROWSâ‰Š clockwise vertical arrows
ğŸ”„	ANTICLOCKWISE DOWNWARDS AND UPWARDS OPEN CIRCLE ARROWSâ‰Š anticlockwise arrows button
ğŸ”™	BACK WITH LEFTWARDS ARROW ABOVEâ‰Š back arrow
ğŸ”š	END WITH LEFTWARDS ARROW ABOVEâ‰Š end arrow
ğŸ”›	ON WITH EXCLAMATION MARK WITH LEFT RIGHT ARROW ABOVEâ‰Š on! arrow
ğŸ”œ	SOON WITH RIGHTWARDS ARROW ABOVEâ‰Š soon arrow
ğŸ”	TOP WITH UPWARDS ARROW ABOVEâ‰Š top arrow
ğŸ›	PLACE OF WORSHIP
âš›	ATOM SYMBOL
ğŸ•‰	OM SYMBOLâ‰Š om
âœ¡	STAR OF DAVID
â˜¸	WHEEL OF DHARMA
â˜¯	YIN YANG
âœ	LATIN CROSS
â˜¦	ORTHODOX CROSS
â˜ª	STAR AND CRESCENT
â˜®	PEACE SYMBOL
ğŸ•	MENORAH WITH NINE BRANCHESâ‰Š menorah
ğŸ”¯	SIX POINTED STAR WITH MIDDLE DOTâ‰Š dotted six-pointed star
â™»	BLACK UNIVERSAL RECYCLING SYMBOLâ‰Š recycling symbol
ğŸ“›	NAME BADGE
âšœ	FLEUR-DE-LIS
ğŸ”°	JAPANESE SYMBOL FOR BEGINNER
ğŸ”±	TRIDENT EMBLEM
â­•	HEAVY LARGE CIRCLE
âœ…	WHITE HEAVY CHECK MARK
â˜‘	BALLOT BOX WITH CHECK
âœ”	HEAVY CHECK MARK
âœ–	HEAVY MULTIPLICATION X
âŒ	CROSS MARK
â	NEGATIVE SQUARED CROSS MARKâ‰Š cross mark button
â•	HEAVY PLUS SIGN
â–	HEAVY MINUS SIGN
â—	HEAVY DIVISION SIGN
â°	CURLY LOOP
â¿	DOUBLE CURLY LOOP
ã€½	PART ALTERNATION MARK
âœ³	EIGHT SPOKED ASTERISKâ‰Š eight-spoked asterisk
âœ´	EIGHT POINTED BLACK STARâ‰Š eight-pointed star
â‡	SPARKLE
â€¼	DOUBLE EXCLAMATION MARK
â‰	EXCLAMATION QUESTION MARK
â“	BLACK QUESTION MARK ORNAMENTâ‰Š question mark
â”	WHITE QUESTION MARK ORNAMENTâ‰Š white question mark
â•	WHITE EXCLAMATION MARK ORNAMENTâ‰Š white exclamation mark
â—	HEAVY EXCLAMATION MARK SYMBOLâ‰Š exclamation mark
ã€°	WAVY DASH
Â©	COPYRIGHT SIGNâ‰Š copyright
Â®	REGISTERED SIGNâ‰Š registered
â„¢	TRADE MARK SIGNâ‰Š trade mark
â™ˆ	ARIES
â™‰	TAURUS
â™Š	GEMINI
â™‹	CANCER
â™Œ	LEO
â™	VIRGO
â™	LIBRA
â™	SCORPIUS
â™	SAGITTARIUS
â™‘	CAPRICORN
â™’	AQUARIUS
â™“	PISCES
â›	OPHIUCHUS
ğŸ”€	TWISTED RIGHTWARDS ARROWSâ‰Š shuffle tracks button
ğŸ”	CLOCKWISE RIGHTWARDS AND LEFTWARDS OPEN CIRCLE ARROWSâ‰Š repeat button
ğŸ”‚	CLOCKWISE RIGHTWARDS AND LEFTWARDS OPEN CIRCLE ARROWS WITH CIRCLED ONE OVERLAYâ‰Š repeat single button
â–¶	BLACK RIGHT-POINTING TRIANGLEâ‰Š play button
â©	BLACK RIGHT-POINTING DOUBLE TRIANGLEâ‰Š fast-forword button
â­	BLACK RIGHT-POINTING DOUBLE TRIANGLE WITH VERTICAL BARâ‰Š next track button
â¯	BLACK RIGHT-POINTING TRIANGLE WITH DOUBLE VERTICAL BARâ‰Š play or pause button
â—€	BLACK LEFT-POINTING TRIANGLEâ‰Š reverse button
âª	BLACK LEFT-POINTING DOUBLE TRIANGLEâ‰Š fast reverse button
â®	BLACK LEFT-POINTING DOUBLE TRIANGLE WITH VERTICAL BARâ‰Š last track button
ğŸ”¼	UP-POINTING SMALL RED TRIANGLEâ‰Š up button
â«	BLACK UP-POINTING DOUBLE TRIANGLEâ‰Š fast up button
ğŸ”½	DOWN-POINTING SMALL RED TRIANGLEâ‰Š down button
â¬	BLACK DOWN-POINTING DOUBLE TRIANGLEâ‰Š fast down button
â¸	DOUBLE VERTICAL BARâ‰Š pause button
â¹	BLACK SQUARE FOR STOPâ‰Š stop button
âº	BLACK CIRCLE FOR RECORDâ‰Š record button
â	EJECT SYMBOLâ‰Š eject button
ğŸ¦	CINEMA
ğŸ”…	LOW BRIGHTNESS SYMBOLâ‰Š dim button
ğŸ”†	HIGH BRIGHTNESS SYMBOLâ‰Š bright button
ğŸ“¶	ANTENNA WITH BARSâ‰Š antenna bars
ğŸ“³	VIBRATION MODE
ğŸ“´	MOBILE PHONE OFF
#ï¸âƒ£	keycap #
*ï¸âƒ£	keycap *
0ï¸âƒ£	keycap 0
1ï¸âƒ£	keycap 1
2ï¸âƒ£	keycap 2
3ï¸âƒ£	keycap 3
4ï¸âƒ£	keycap 4
5ï¸âƒ£	keycap 5
6ï¸âƒ£	keycap 6
7ï¸âƒ£	keycap 7
8ï¸âƒ£	keycap 8
9ï¸âƒ£	keycap 9
ğŸ”Ÿ	KEYCAP TENâ‰Š keycap #
ğŸ’¯	HUNDRED POINTS SYMBOLâ‰Š hundred points
ğŸ” 	INPUT SYMBOL FOR LATIN CAPITAL LETTERSâ‰Š input latin uppercase
ğŸ”¡	INPUT SYMBOL FOR LATIN SMALL LETTERSâ‰Š input latin lowercase
ğŸ”¢	INPUT SYMBOL FOR NUMBERSâ‰Š input numbers
ğŸ”£	INPUT SYMBOL FOR SYMBOLSâ‰Š input symbols
ğŸ”¤	INPUT SYMBOL FOR LATIN LETTERSâ‰Š input latin letters
ğŸ…°	NEGATIVE SQUARED LATIN CAPITAL LETTER Aâ‰Š a button
ğŸ†	NEGATIVE SQUARED ABâ‰Š ab button
ğŸ…±	NEGATIVE SQUARED LATIN CAPITAL LETTER Bâ‰Š b button
ğŸ†‘	SQUARED CL
ğŸ†’	SQUARED COOL
ğŸ†“	SQUARED FREE
â„¹	INFORMATION SOURCE
ğŸ†”	SQUARED ID
â“‚	CIRCLED LATIN CAPITAL LETTER Mâ‰Š circled letter m
ğŸ†•	SQUARED NEW
ğŸ†–	SQUARED NG
ğŸ…¾	NEGATIVE SQUARED LATIN CAPITAL LETTER Oâ‰Š o button
ğŸ†—	SQUARED OK
ğŸ…¿	NEGATIVE SQUARED LATIN CAPITAL LETTER Pâ‰Š p button
ğŸ†˜	SQUARED SOS
ğŸ†™	SQUARED UP WITH EXCLAMATION MARKâ‰Š up! button
ğŸ†š	SQUARED VS
ğŸˆ	SQUARED KATAKANA KOKO
ğŸˆ‚	SQUARED KATAKANA SA
ğŸˆ·	SQUARED CJK UNIFIED IDEOGRAPH-6708â‰Š squared moon ideograph
ğŸˆ¶	SQUARED CJK UNIFIED IDEOGRAPH-6709â‰Š squared exist ideograph
ğŸˆ¯	SQUARED CJK UNIFIED IDEOGRAPH-6307â‰Š squared finger ideograph
ğŸ‰	CIRCLED IDEOGRAPH ADVANTAGEâ‰Š circled advantage ideograph
ğŸˆ¹	SQUARED CJK UNIFIED IDEOGRAPH-5272â‰Š squared divide ideograph
ğŸˆš	SQUARED CJK UNIFIED IDEOGRAPH-7121â‰Š squared negation ideograph
ğŸˆ²	SQUARED CJK UNIFIED IDEOGRAPH-7981â‰Š squared prohibit ideograph
ğŸ‰‘	CIRCLED IDEOGRAPH ACCEPTâ‰Š circled accept ideograph
ğŸˆ¸	SQUARED CJK UNIFIED IDEOGRAPH-7533â‰Š squared apply ideograph
ğŸˆ´	SQUARED CJK UNIFIED IDEOGRAPH-5408â‰Š squared together ideograph
ğŸˆ³	SQUARED CJK UNIFIED IDEOGRAPH-7A7Aâ‰Š squared empty ideograph
ãŠ—	CIRCLED IDEOGRAPH CONGRATULATIONâ‰Š circled congratulate ideograph
ãŠ™	CIRCLED IDEOGRAPH SECRETâ‰Š circled secret ideograph
ğŸˆº	SQUARED CJK UNIFIED IDEOGRAPH-55B6â‰Š squared operating ideograph
ğŸˆµ	SQUARED CJK UNIFIED IDEOGRAPH-6E80â‰Š squared fullness ideograph
â–ª	BLACK SMALL SQUARE
â–«	WHITE SMALL SQUARE
â—»	WHITE MEDIUM SQUARE
â—¼	BLACK MEDIUM SQUARE
â—½	WHITE MEDIUM SMALL SQUAREâ‰Š white medium-small square
â—¾	BLACK MEDIUM SMALL SQUAREâ‰Š black medium-small square
â¬›	BLACK LARGE SQUARE
â¬œ	WHITE LARGE SQUARE
ğŸ”¶	LARGE ORANGE DIAMOND
ğŸ”·	LARGE BLUE DIAMOND
ğŸ”¸	SMALL ORANGE DIAMOND
ğŸ”¹	SMALL BLUE DIAMOND
ğŸ”º	UP-POINTING RED TRIANGLEâ‰Š red triangle pointed up
ğŸ”»	DOWN-POINTING RED TRIANGLEâ‰Š red triangle pointed down
ğŸ’ 	DIAMOND SHAPE WITH A DOT INSIDEâ‰Š diamond with a dot
ğŸ”˜	RADIO BUTTON
ğŸ”²	BLACK SQUARE BUTTON
ğŸ”³	WHITE SQUARE BUTTON
âšª	MEDIUM WHITE CIRCLEâ‰Š white circle
âš«	MEDIUM BLACK CIRCLEâ‰Š black circle
ğŸ”´	LARGE RED CIRCLEâ‰Š red circle
ğŸ”µ	LARGE BLUE CIRCLEâ‰Š blue circle
ğŸ	CHEQUERED FLAG
ğŸš©	TRIANGULAR FLAG ON POSTâ‰Š triangular flag
ğŸŒ	CROSSED FLAGS
ğŸ´	WAVING BLACK FLAG
ğŸ³	WAVING WHITE FLAG
ğŸ‡¦ğŸ‡¨	Ascension Island
ğŸ‡¦ğŸ‡©	Andorra
ğŸ‡¦ğŸ‡ª	United Arab Emirates
ğŸ‡¦ğŸ‡«	Afghanistan
ğŸ‡¦ğŸ‡¬	Antigua & Barbuda
ğŸ‡¦ğŸ‡®	Anguilla
ğŸ‡¦ğŸ‡±	Albania
ğŸ‡¦ğŸ‡²	Armenia
ğŸ‡¦ğŸ‡´	Angola
ğŸ‡¦ğŸ‡¶	Antarctica
ğŸ‡¦ğŸ‡·	Argentina
ğŸ‡¦ğŸ‡¸	American Samoa
ğŸ‡¦ğŸ‡¹	Austria
ğŸ‡¦ğŸ‡º	Australia
ğŸ‡¦ğŸ‡¼	Aruba
ğŸ‡¦ğŸ‡½	Ã…land Islands
ğŸ‡¦ğŸ‡¿	Azerbaijan
ğŸ‡§ğŸ‡¦	Bosnia & Herzegovina
ğŸ‡§ğŸ‡§	Barbados
ğŸ‡§ğŸ‡©	Bangladesh
ğŸ‡§ğŸ‡ª	Belgium
ğŸ‡§ğŸ‡«	Burkina Faso
ğŸ‡§ğŸ‡¬	Bulgaria
ğŸ‡§ğŸ‡­	Bahrain
ğŸ‡§ğŸ‡®	Burundi
ğŸ‡§ğŸ‡¯	Benin
ğŸ‡§ğŸ‡±	St. BarthÃ©lemy
ğŸ‡§ğŸ‡²	Bermuda
ğŸ‡§ğŸ‡³	Brunei
ğŸ‡§ğŸ‡´	Bolivia
ğŸ‡§ğŸ‡¶	Caribbean Netherlands
ğŸ‡§ğŸ‡·	Brazil
ğŸ‡§ğŸ‡¸	Bahamas
ğŸ‡§ğŸ‡¹	Bhutan
ğŸ‡§ğŸ‡»	Bouvet Island
ğŸ‡§ğŸ‡¼	Botswana
ğŸ‡§ğŸ‡¾	Belarus
ğŸ‡§ğŸ‡¿	Belize
ğŸ‡¨ğŸ‡¦	Canada
ğŸ‡¨ğŸ‡¨	Cocos (Keeling) Islands
ğŸ‡¨ğŸ‡©	Congo - Kinshasa
ğŸ‡¨ğŸ‡«	Central African Republic
ğŸ‡¨ğŸ‡¬	Congo - Brazzaville
ğŸ‡¨ğŸ‡­	Switzerland
ğŸ‡¨ğŸ‡®	CÃ´te dâ€™Ivoire
ğŸ‡¨ğŸ‡°	Cook Islands
ğŸ‡¨ğŸ‡±	Chile
ğŸ‡¨ğŸ‡²	Cameroon
ğŸ‡¨ğŸ‡³	China
ğŸ‡¨ğŸ‡´	Colombia
ğŸ‡¨ğŸ‡µ	Clipperton Island
ğŸ‡¨ğŸ‡·	Costa Rica
ğŸ‡¨ğŸ‡º	Cuba
ğŸ‡¨ğŸ‡»	Cape Verde
ğŸ‡¨ğŸ‡¼	CuraÃ§ao
ğŸ‡¨ğŸ‡½	Christmas Island
ğŸ‡¨ğŸ‡¾	Cyprus
ğŸ‡¨ğŸ‡¿	Czech Republic
ğŸ‡©ğŸ‡ª	Germany
ğŸ‡©ğŸ‡¬	Diego Garcia
ğŸ‡©ğŸ‡¯	Djibouti
ğŸ‡©ğŸ‡°	Denmark
ğŸ‡©ğŸ‡²	Dominica
ğŸ‡©ğŸ‡´	Dominican Republic
ğŸ‡©ğŸ‡¿	Algeria
ğŸ‡ªğŸ‡¦	Ceuta & Melilla
ğŸ‡ªğŸ‡¨	Ecuador
ğŸ‡ªğŸ‡ª	Estonia
ğŸ‡ªğŸ‡¬	Egypt
ğŸ‡ªğŸ‡­	Western Sahara
ğŸ‡ªğŸ‡·	Eritrea
ğŸ‡ªğŸ‡¸	Spain
ğŸ‡ªğŸ‡¹	Ethiopia
ğŸ‡ªğŸ‡º	European Union
ğŸ‡«ğŸ‡®	Finland
ğŸ‡«ğŸ‡¯	Fiji
ğŸ‡«ğŸ‡°	Falkland Islands
ğŸ‡«ğŸ‡²	Micronesia
ğŸ‡«ğŸ‡´	Faroe Islands
ğŸ‡«ğŸ‡·	France
ğŸ‡¬ğŸ‡¦	Gabon
ğŸ‡¬ğŸ‡§	United Kingdom
ğŸ‡¬ğŸ‡©	Grenada
ğŸ‡¬ğŸ‡ª	Georgia
ğŸ‡¬ğŸ‡«	French Guiana
ğŸ‡¬ğŸ‡¬	Guernsey
ğŸ‡¬ğŸ‡­	Ghana
ğŸ‡¬ğŸ‡®	Gibraltar
ğŸ‡¬ğŸ‡±	Greenland
ğŸ‡¬ğŸ‡²	Gambia
ğŸ‡¬ğŸ‡³	Guinea
ğŸ‡¬ğŸ‡µ	Guadeloupe
ğŸ‡¬ğŸ‡¶	Equatorial Guinea
ğŸ‡¬ğŸ‡·	Greece
ğŸ‡¬ğŸ‡¸	South Georgia & South Sandwich Islands
ğŸ‡¬ğŸ‡¹	Guatemala
ğŸ‡¬ğŸ‡º	Guam
ğŸ‡¬ğŸ‡¼	Guinea-Bissau
ğŸ‡¬ğŸ‡¾	Guyana
ğŸ‡­ğŸ‡°	Hong Kong SAR China
ğŸ‡­ğŸ‡²	Heard & McDonald Islands
ğŸ‡­ğŸ‡³	Honduras
ğŸ‡­ğŸ‡·	Croatia
ğŸ‡­ğŸ‡¹	Haiti
ğŸ‡­ğŸ‡º	Hungary
ğŸ‡®ğŸ‡¨	Canary Islands
ğŸ‡®ğŸ‡©	Indonesia
ğŸ‡®ğŸ‡ª	Ireland
ğŸ‡®ğŸ‡±	Israel
ğŸ‡®ğŸ‡²	Isle of Man
ğŸ‡®ğŸ‡³	India
ğŸ‡®ğŸ‡´	British Indian Ocean Territory
ğŸ‡®ğŸ‡¶	Iraq
ğŸ‡®ğŸ‡·	Iran
ğŸ‡®ğŸ‡¸	Iceland
ğŸ‡®ğŸ‡¹	Italy
ğŸ‡¯ğŸ‡ª	Jersey
ğŸ‡¯ğŸ‡²	Jamaica
ğŸ‡¯ğŸ‡´	Jordan
ğŸ‡¯ğŸ‡µ	Japan
ğŸ‡°ğŸ‡ª	Kenya
ğŸ‡°ğŸ‡¬	Kyrgyzstan
ğŸ‡°ğŸ‡­	Cambodia
ğŸ‡°ğŸ‡®	Kiribati
ğŸ‡°ğŸ‡²	Comoros
ğŸ‡°ğŸ‡³	St. Kitts & Nevis
ğŸ‡°ğŸ‡µ	North Korea
ğŸ‡°ğŸ‡·	South Korea
ğŸ‡°ğŸ‡¼	Kuwait
ğŸ‡°ğŸ‡¾	Cayman Islands
ğŸ‡°ğŸ‡¿	Kazakhstan
ğŸ‡±ğŸ‡¦	Laos
ğŸ‡±ğŸ‡§	Lebanon
ğŸ‡±ğŸ‡¨	St. Lucia
ğŸ‡±ğŸ‡®	Liechtenstein
ğŸ‡±ğŸ‡°	Sri Lanka
ğŸ‡±ğŸ‡·	Liberia
ğŸ‡±ğŸ‡¸	Lesotho
ğŸ‡±ğŸ‡¹	Lithuania
ğŸ‡±ğŸ‡º	Luxembourg
ğŸ‡±ğŸ‡»	Latvia
ğŸ‡±ğŸ‡¾	Libya
ğŸ‡²ğŸ‡¦	Morocco
ğŸ‡²ğŸ‡¨	Monaco
ğŸ‡²ğŸ‡©	Moldova
ğŸ‡²ğŸ‡ª	Montenegro
ğŸ‡²ğŸ‡«	St. Martin
ğŸ‡²ğŸ‡¬	Madagascar
ğŸ‡²ğŸ‡­	Marshall Islands
ğŸ‡²ğŸ‡°	Macedonia
ğŸ‡²ğŸ‡±	Mali
ğŸ‡²ğŸ‡²	Myanmar (Burma)
ğŸ‡²ğŸ‡³	Mongolia
ğŸ‡²ğŸ‡´	Macau SAR China
ğŸ‡²ğŸ‡µ	Northern Mariana Islands
ğŸ‡²ğŸ‡¶	Martinique
ğŸ‡²ğŸ‡·	Mauritania
ğŸ‡²ğŸ‡¸	Montserrat
ğŸ‡²ğŸ‡¹	Malta
ğŸ‡²ğŸ‡º	Mauritius
ğŸ‡²ğŸ‡»	Maldives
ğŸ‡²ğŸ‡¼	Malawi
ğŸ‡²ğŸ‡½	Mexico
ğŸ‡²ğŸ‡¾	Malaysia
ğŸ‡²ğŸ‡¿	Mozambique
ğŸ‡³ğŸ‡¦	Namibia
ğŸ‡³ğŸ‡¨	New Caledonia
ğŸ‡³ğŸ‡ª	Niger
ğŸ‡³ğŸ‡«	Norfolk Island
ğŸ‡³ğŸ‡¬	Nigeria
ğŸ‡³ğŸ‡®	Nicaragua
ğŸ‡³ğŸ‡±	Netherlands
ğŸ‡³ğŸ‡´	Norway
ğŸ‡³ğŸ‡µ	Nepal
ğŸ‡³ğŸ‡·	Nauru
ğŸ‡³ğŸ‡º	Niue
ğŸ‡³ğŸ‡¿	New Zealand
ğŸ‡´ğŸ‡²	Oman
ğŸ‡µğŸ‡¦	Panama
ğŸ‡µğŸ‡ª	Peru
ğŸ‡µğŸ‡«	French Polynesia
ğŸ‡µğŸ‡¬	Papua New Guinea
ğŸ‡µğŸ‡­	Philippines
ğŸ‡µğŸ‡°	Pakistan
ğŸ‡µğŸ‡±	Poland
ğŸ‡µğŸ‡²	St. Pierre & Miquelon
ğŸ‡µğŸ‡³	Pitcairn Islands
ğŸ‡µğŸ‡·	Puerto Rico
ğŸ‡µğŸ‡¸	Palestinian Territories
ğŸ‡µğŸ‡¹	Portugal
ğŸ‡µğŸ‡¼	Palau
ğŸ‡µğŸ‡¾	Paraguay
ğŸ‡¶ğŸ‡¦	Qatar
ğŸ‡·ğŸ‡ª	RÃ©union
ğŸ‡·ğŸ‡´	Romania
ğŸ‡·ğŸ‡¸	Serbia
ğŸ‡·ğŸ‡º	Russia
ğŸ‡·ğŸ‡¼	Rwanda
ğŸ‡¸ğŸ‡¦	Saudi Arabia
ğŸ‡¸ğŸ‡§	Solomon Islands
ğŸ‡¸ğŸ‡¨	Seychelles
ğŸ‡¸ğŸ‡©	Sudan
ğŸ‡¸ğŸ‡ª	Sweden
ğŸ‡¸ğŸ‡¬	Singapore
ğŸ‡¸ğŸ‡­	St. Helena
ğŸ‡¸ğŸ‡®	Slovenia
ğŸ‡¸ğŸ‡¯	Svalbard & Jan Mayen
ğŸ‡¸ğŸ‡°	Slovakia
ğŸ‡¸ğŸ‡±	Sierra Leone
ğŸ‡¸ğŸ‡²	San Marino
ğŸ‡¸ğŸ‡³	Senegal
ğŸ‡¸ğŸ‡´	Somalia
ğŸ‡¸ğŸ‡·	Suriname
ğŸ‡¸ğŸ‡¸	South Sudan
ğŸ‡¸ğŸ‡¹	SÃ£o TomÃ© & PrÃ­ncipe
ğŸ‡¸ğŸ‡»	El Salvador
ğŸ‡¸ğŸ‡½	Sint Maarten
ğŸ‡¸ğŸ‡¾	Syria
ğŸ‡¸ğŸ‡¿	Swaziland
ğŸ‡¹ğŸ‡¦	Tristan da Cunha
ğŸ‡¹ğŸ‡¨	Turks & Caicos Islands
ğŸ‡¹ğŸ‡©	Chad
ğŸ‡¹ğŸ‡«	French Southern Territories
ğŸ‡¹ğŸ‡¬	Togo
ğŸ‡¹ğŸ‡­	Thailand
ğŸ‡¹ğŸ‡¯	Tajikistan
ğŸ‡¹ğŸ‡°	Tokelau
ğŸ‡¹ğŸ‡±	Timor-Leste
ğŸ‡¹ğŸ‡²	Turkmenistan
ğŸ‡¹ğŸ‡³	Tunisia
ğŸ‡¹ğŸ‡´	Tonga
ğŸ‡¹ğŸ‡·	Turkey
ğŸ‡¹ğŸ‡¹	Trinidad & Tobago
ğŸ‡¹ğŸ‡»	Tuvalu
ğŸ‡¹ğŸ‡¼	Taiwan
ğŸ‡¹ğŸ‡¿	Tanzania
ğŸ‡ºğŸ‡¦	Ukraine
ğŸ‡ºğŸ‡¬	Uganda
ğŸ‡ºğŸ‡²	U.S. Outlying Islands
ğŸ‡ºğŸ‡¸	United States
ğŸ‡ºğŸ‡¾	Uruguay
ğŸ‡ºğŸ‡¿	Uzbekistan
ğŸ‡»ğŸ‡¦	Vatican City
ğŸ‡»ğŸ‡¨	St. Vincent & Grenadines
ğŸ‡»ğŸ‡ª	Venezuela
ğŸ‡»ğŸ‡¬	British Virgin Islands
ğŸ‡»ğŸ‡®	U.S. Virgin Islands
ğŸ‡»ğŸ‡³	Vietnam
ğŸ‡»ğŸ‡º	Vanuatu
ğŸ‡¼ğŸ‡«	Wallis & Futuna
ğŸ‡¼ğŸ‡¸	Samoa
ğŸ‡½ğŸ‡°	Kosovo
ğŸ‡¾ğŸ‡ª	Yemen
ğŸ‡¾ğŸ‡¹	Mayotte
ğŸ‡¿ğŸ‡¦	South Africa
ğŸ‡¿ğŸ‡²	Zambia
ğŸ‡¿ğŸ‡¼	Zimbabwe
